Subject Name,Class Name,Methods #,Methods # cov,Methods # not-cov,Methods # req,Methods # pseudo,Methods % covered,Methods % pseudo,Statements #,Statements # cov,Statements # not-cov,Statements # req,Statements # pseudo,Statements # PTSIRM,Statements % covered,Statements % pseudo,# PIT mutants,# PIT mutants killed,% PIT mutants killed
lib-logger,com.github.naoghuman.lib.logger.core.LoggerFacade,18,0,18,0,0,0.0,0.0,19,0,19,0,0,0,0.0,0.0,17,0,0.0
lib-logger,com.github.naoghuman.lib.logger.core.Logger,0,0,0,0,0,0.0,0.0,0,0,0,0,0,0,0.0,0.0,0,0,0
lib-logger,com.github.naoghuman.lib.logger.internal.DefaultLoggerValidator,1,1,0,1,0,100.0,0.0,1,1,0,1,0,0,100.0,0.0,0,0,0
lib-logger,com.github.naoghuman.lib.logger.internal.DefaultLogger,17,4,13,1,3,23.53,17.65,75,17,58,0,17,4,22.67,22.67,26,3,11.54
commons-codec,org.apache.commons.codec.StringEncoder,0,0,0,0,0,0.0,0.0,0,0,0,0,0,0,0.0,0.0,0,0,0
commons-codec,org.apache.commons.codec.Encoder,0,0,0,0,0,0.0,0.0,0,0,0,0,0,0,0.0,0.0,0,0,0
commons-codec,org.apache.commons.codec.StringEncoderComparator,1,1,0,1,0,100.0,0.0,7,6,1,6,0,0,85.71,0.0,1,1,100.0
commons-codec,org.apache.commons.codec.BinaryEncoder,0,0,0,0,0,0.0,0.0,0,0,0,0,0,0,0.0,0.0,0,0,0
commons-codec,org.apache.commons.codec.CharEncoding,0,0,0,0,0,0.0,0.0,0,0,0,0,0,0,0.0,0.0,0,0,0
commons-codec,org.apache.commons.codec.Resources,1,1,0,1,0,100.0,0.0,4,4,0,4,0,0,100.0,0.0,2,1,50.0
commons-codec,org.apache.commons.codec.StringDecoder,0,0,0,0,0,0.0,0.0,0,0,0,0,0,0,0.0,0.0,0,0,0
commons-codec,org.apache.commons.codec.EncoderException,0,0,0,0,0,0.0,0.0,0,0,0,0,0,0,0.0,0.0,0,0,0
commons-codec,org.apache.commons.codec.Decoder,0,0,0,0,0,0.0,0.0,0,0,0,0,0,0,0.0,0.0,0,0,0
commons-codec,org.apache.commons.codec.Charsets,2,0,2,0,0,0.0,0.0,2,0,2,0,0,0,0.0,0.0,4,0,0.0
commons-codec,org.apache.commons.codec.DecoderException,0,0,0,0,0,0.0,0.0,0,0,0,0,0,0,0.0,0.0,0,0,0
commons-codec,org.apache.commons.codec.BinaryDecoder,0,0,0,0,0,0.0,0.0,0,0,0,0,0,0,0.0,0.0,0,0,0
commons-codec,org.apache.commons.codec.CodecPolicy,0,0,0,0,0,0.0,0.0,0,0,0,0,0,0,0.0,0.0,0,0,0
commons-codec,org.apache.commons.codec.net.BCodec,10,9,1,9,0,90.0,0.0,46,40,6,40,0,0,86.96,0.0,25,21,84.0
commons-codec,org.apache.commons.codec.net.URLCodec,10,10,0,10,0,100.0,0.0,79,79,0,79,0,0,100.0,0.0,50,49,98.0
commons-codec,org.apache.commons.codec.net.PercentCodec,13,13,0,12,1,100.0,7.69,88,88,0,87,1,1,100.0,1.14,67,58,86.57
commons-codec,org.apache.commons.codec.net.QCodec,10,9,1,9,0,90.0,0.0,67,60,7,60,0,0,89.55,0.0,35,30,85.71
commons-codec,org.apache.commons.codec.net.QuotedPrintableCodec,18,17,1,17,0,94.44,0.0,121,118,3,118,0,0,97.52,0.0,100,93,93.0
commons-codec,org.apache.commons.codec.net.RFC1522Codec,3,3,0,3,0,100.0,0.0,42,39,3,39,0,0,92.86,0.0,18,15,83.33
commons-codec,org.apache.commons.codec.net.Utils,2,2,0,2,0,100.0,0.0,5,5,0,5,0,0,100.0,0.0,4,4,100.0
commons-codec,org.apache.commons.codec.digest.XXHash32,7,4,3,0,4,57.14,57.14,67,0,67,0,0,0,0.0,0.0,89,14,15.73
commons-codec,org.apache.commons.codec.digest.Sha2Crypt,7,7,0,7,0,100.0,0.0,144,137,7,137,0,0,95.14,0.0,112,97,86.61
commons-codec,org.apache.commons.codec.digest.HmacAlgorithms,1,0,1,0,0,0.0,0.0,2,1,1,0,1,0,50.0,50.0,1,0,0.0
commons-codec,org.apache.commons.codec.digest.Blake3$ChunkState,4,0,4,0,0,0.0,0.0,18,0,18,0,0,0,0.0,0.0,18,0,0.0
commons-codec,org.apache.commons.codec.digest.PureJavaCrc32C,4,3,1,3,0,75.0,0.0,21,13,8,13,0,0,61.9,0.0,92,43,46.74
commons-codec,org.apache.commons.codec.digest.MurmurHash2,10,10,0,10,0,100.0,0.0,48,48,0,48,0,0,100.0,0.0,130,130,100.0
commons-codec,org.apache.commons.codec.digest.MurmurHash3$IncrementalHash32x86,5,5,0,5,0,100.0,0.0,48,47,1,47,0,0,97.92,0.0,52,51,98.08
commons-codec,org.apache.commons.codec.digest.DigestUtils,114,107,7,107,0,93.86,0.0,136,122,14,121,1,1,89.71,0.74,124,112,90.32
commons-codec,org.apache.commons.codec.digest.MurmurHash3,15,15,0,15,0,100.0,0.0,107,107,0,107,0,0,100.0,0.0,198,198,100.0
commons-codec,org.apache.commons.codec.digest.MessageDigestAlgorithms,1,0,1,0,0,0.0,0.0,1,0,1,0,0,0,0.0,0.0,1,0,0.0
commons-codec,org.apache.commons.codec.digest.Blake3,17,1,16,1,0,5.88,0.0,70,4,66,4,0,0,5.71,0.0,79,1,1.27
commons-codec,org.apache.commons.codec.digest.UnixCrypt,12,12,0,12,0,100.0,0.0,130,130,0,130,0,0,100.0,0.0,206,200,97.09
commons-codec,org.apache.commons.codec.digest.HmacUtils,17,11,6,11,0,64.71,0.0,45,31,14,29,2,1,68.89,4.44,32,19,59.38
commons-codec,org.apache.commons.codec.digest.PureJavaCrc32,5,5,0,5,0,100.0,0.0,19,19,0,19,0,0,100.0,0.0,103,102,99.03
commons-codec,org.apache.commons.codec.digest.Blake3$EngineState,6,0,6,0,0,0.0,0.0,30,0,30,0,0,0,0.0,0.0,21,0,0.0
commons-codec,org.apache.commons.codec.digest.Blake3$Output,2,0,2,0,0,0.0,0.0,17,0,17,0,0,0,0.0,0.0,12,0,0.0
commons-codec,org.apache.commons.codec.digest.B64,3,3,0,3,0,100.0,0.0,11,11,0,11,0,0,100.0,0.0,16,15,93.75
commons-codec,org.apache.commons.codec.digest.Crypt,4,4,0,4,0,100.0,0.0,16,16,0,16,0,0,100.0,0.0,12,12,100.0
commons-codec,org.apache.commons.codec.digest.Md5Crypt,10,10,0,10,0,100.0,0.0,72,72,0,72,0,0,100.0,0.0,58,52,89.66
commons-codec,org.apache.commons.codec.language.SoundexUtils,4,4,0,4,0,100.0,0.0,25,25,0,25,0,0,100.0,0.0,20,20,100.0
commons-codec,org.apache.commons.codec.language.ColognePhonetic$CologneInputBuffer,4,3,1,3,0,75.0,0.0,6,4,2,4,0,0,66.67,0.0,9,5,55.56
commons-codec,org.apache.commons.codec.language.DaitchMokotoffSoundex$Branch,6,6,0,4,2,100.0,33.33,30,26,4,26,0,0,86.67,0.0,20,12,60.0
commons-codec,org.apache.commons.codec.language.Caverphone1,1,1,0,1,0,100.0,0.0,61,61,0,28,33,33,100.0,54.1,4,3,75.0
commons-codec,org.apache.commons.codec.language.ColognePhonetic$CologneBuffer,3,3,0,3,0,100.0,0.0,7,7,0,7,0,0,100.0,0.0,4,4,100.0
commons-codec,org.apache.commons.codec.language.Nysiis,6,6,0,6,0,100.0,0.0,73,73,0,72,1,1,100.0,1.37,71,66,92.96
commons-codec,org.apache.commons.codec.language.DaitchMokotoffSoundex,7,7,0,5,2,100.0,28.57,108,97,11,96,1,1,89.81,0.93,41,32,78.05
commons-codec,org.apache.commons.codec.language.Soundex,6,6,0,5,1,100.0,16.67,46,46,0,46,0,0,100.0,0.0,30,24,80.0
commons-codec,org.apache.commons.codec.language.DoubleMetaphone$DoubleMetaphoneResult,11,11,0,11,0,100.0,0.0,26,26,0,26,0,0,100.0,0.0,25,20,80.0
commons-codec,org.apache.commons.codec.language.MatchRatingApproachEncoder,11,11,0,11,0,100.0,0.0,119,117,2,115,2,2,98.32,1.68,88,83,94.32
commons-codec,org.apache.commons.codec.language.Caverphone2,1,1,0,1,0,100.0,0.0,64,64,0,41,23,23,100.0,35.94,3,2,66.67
commons-codec,org.apache.commons.codec.language.DoubleMetaphone,35,35,0,34,1,100.0,2.86,443,432,11,419,13,11,97.52,2.93,556,495,89.03
commons-codec,org.apache.commons.codec.language.Metaphone,9,9,0,7,2,100.0,22.22,175,175,0,149,26,16,100.0,14.86,128,116,90.62
commons-codec,org.apache.commons.codec.language.AbstractCaverphone,2,2,0,2,0,100.0,0.0,5,5,0,4,1,1,100.0,20.0,4,3,75.0
commons-codec,org.apache.commons.codec.language.ColognePhonetic$CologneOutputBuffer,2,2,0,2,0,100.0,0.0,7,7,0,7,0,0,100.0,0.0,6,6,100.0
commons-codec,org.apache.commons.codec.language.DaitchMokotoffSoundex$Rule,5,4,1,4,0,80.0,0.0,15,14,1,14,0,0,93.33,0.0,18,16,88.89
commons-codec,org.apache.commons.codec.language.RefinedSoundex,5,5,0,5,0,100.0,0.0,36,36,0,35,1,1,100.0,2.78,20,16,80.0
commons-codec,org.apache.commons.codec.language.ColognePhonetic,6,6,0,5,1,100.0,16.67,85,84,1,82,2,1,98.82,2.35,57,53,92.98
commons-codec,org.apache.commons.codec.language.bm.RuleType,0,0,0,0,0,0.0,0.0,1,1,0,0,1,0,100.0,100.0,0,0,0
commons-codec,org.apache.commons.codec.language.bm.Lang$LangRule,1,1,0,0,1,100.0,100.0,4,4,0,1,3,0,100.0,75.0,2,1,50.0
commons-codec,org.apache.commons.codec.language.bm.Rule,18,17,1,8,9,94.44,50.0,152,133,19,38,95,1,87.5,62.5,94,52,55.32
commons-codec,org.apache.commons.codec.language.bm.Rule$PhonemeExpr,0,0,0,0,0,0.0,0.0,0,0,0,0,0,0,0.0,0.0,0,0,0
commons-codec,org.apache.commons.codec.language.bm.Languages,5,3,2,1,2,60.0,40.0,21,19,2,2,17,10,90.48,80.95,6,0,0.0
commons-codec,org.apache.commons.codec.language.bm.PhoneticEngine,5,5,0,5,0,100.0,0.0,55,48,7,46,2,1,87.27,3.64,31,26,83.87
commons-codec,org.apache.commons.codec.language.bm.BeiderMorseEncoder,5,5,0,3,2,100.0,40.0,11,11,0,8,3,1,100.0,27.27,9,6,66.67
commons-codec,org.apache.commons.codec.language.bm.PhoneticEngine$PhonemeBuilder,4,4,0,4,0,100.0,0.0,18,18,0,18,0,0,100.0,0.0,9,7,77.78
commons-codec,org.apache.commons.codec.language.bm.Languages$LanguageSet,1,1,0,1,0,100.0,0.0,1,1,0,1,0,0,100.0,0.0,2,2,100.0
commons-codec,org.apache.commons.codec.language.bm.Rule$Phoneme,3,2,1,2,0,66.67,0.0,7,6,1,6,0,0,85.71,0.0,3,2,66.67
commons-codec,org.apache.commons.codec.language.bm.NameType,0,0,0,0,0,0.0,0.0,1,1,0,0,1,0,100.0,100.0,0,0,0
commons-codec,org.apache.commons.codec.language.bm.Languages$SomeLanguages,7,5,2,4,1,71.43,14.29,21,15,6,13,2,1,71.43,9.52,20,14,70.0
commons-codec,org.apache.commons.codec.language.bm.Rule$RPattern,0,0,0,0,0,0.0,0.0,0,0,0,0,0,0,0.0,0.0,0,0,0
commons-codec,org.apache.commons.codec.language.bm.ResourceConstants,0,0,0,0,0,0.0,0.0,0,0,0,0,0,0,0.0,0.0,0,0,0
commons-codec,org.apache.commons.codec.language.bm.Lang,4,3,1,3,0,75.0,0.0,31,28,3,4,24,16,90.32,77.42,17,5,29.41
commons-codec,org.apache.commons.codec.language.bm.PhoneticEngine$RulesApplication,1,1,0,1,0,100.0,0.0,7,7,0,7,0,0,100.0,0.0,2,2,100.0
commons-codec,org.apache.commons.codec.language.bm.Rule$PhonemeList,0,0,0,0,0,0.0,0.0,1,1,0,0,1,0,100.0,100.0,0,0,0
commons-codec,org.apache.commons.codec.cli.Digest,9,1,8,1,0,11.11,0.0,47,7,40,7,0,0,14.89,0.0,24,0,0.0
commons-codec,org.apache.commons.codec.binary.BaseNCodec$Context,1,1,0,1,0,100.0,0.0,1,1,0,1,0,0,100.0,0.0,1,1,100.0
commons-codec,org.apache.commons.codec.binary.Base16OutputStream,0,0,0,0,0,0.0,0.0,0,0,0,0,0,0,0.0,0.0,0,0,0
commons-codec,org.apache.commons.codec.binary.Base32OutputStream,0,0,0,0,0,0.0,0.0,0,0,0,0,0,0,0.0,0.0,0,0,0
commons-codec,org.apache.commons.codec.binary.BaseNCodecInputStream,6,5,1,5,0,83.33,0.0,51,48,3,46,2,1,94.12,3.92,44,29,65.91
commons-codec,org.apache.commons.codec.binary.CharSequenceUtils,1,1,0,1,0,100.0,0.0,18,16,2,16,0,0,88.89,0.0,16,13,81.25
commons-codec,org.apache.commons.codec.binary.BinaryCodec,11,11,0,11,0,100.0,0.0,71,71,0,71,0,0,100.0,0.0,78,78,100.0
commons-codec,org.apache.commons.codec.binary.Base16,5,5,0,5,0,100.0,0.0,57,57,0,57,0,0,100.0,0.0,59,52,88.14
commons-codec,org.apache.commons.codec.binary.Base64InputStream,0,0,0,0,0,0.0,0.0,0,0,0,0,0,0,0.0,0.0,0,0,0
commons-codec,org.apache.commons.codec.binary.BaseNCodecOutputStream,7,7,0,7,0,100.0,0.0,35,35,0,35,0,0,100.0,0.0,32,26,81.25
commons-codec,org.apache.commons.codec.binary.Hex,26,26,0,25,1,100.0,3.85,77,77,0,74,3,1,100.0,3.9,68,66,97.06
commons-codec,org.apache.commons.codec.binary.Base32InputStream,0,0,0,0,0,0.0,0.0,0,0,0,0,0,0,0.0,0.0,0,0,0
commons-codec,org.apache.commons.codec.binary.Base16InputStream,0,0,0,0,0,0.0,0.0,0,0,0,0,0,0,0.0,0.0,0,0,0
commons-codec,org.apache.commons.codec.binary.BaseNCodec,20,20,0,18,2,100.0,10.0,92,92,0,91,1,0,100.0,1.09,81,69,85.19
commons-codec,org.apache.commons.codec.binary.Base64,22,22,0,22,0,100.0,0.0,151,149,2,149,0,0,98.68,0.0,162,148,91.36
commons-codec,org.apache.commons.codec.binary.StringUtils,20,20,0,20,0,100.0,0.0,42,42,0,42,0,0,100.0,0.0,37,36,97.3
commons-codec,org.apache.commons.codec.binary.Base32,5,5,0,5,0,100.0,0.0,166,164,2,164,0,0,98.8,0.0,216,199,92.13
commons-codec,org.apache.commons.codec.binary.Base64OutputStream,0,0,0,0,0,0.0,0.0,0,0,0,0,0,0,0.0,0.0,0,0,0
f3270,net.sf.f3270.TerminalWindowObserver,3,0,3,0,0,0.0,0.0,4,0,4,0,0,0,0.0,0.0,3,0,0.0
f3270,net.sf.f3270.TerminalType,0,0,0,0,0,0.0,0.0,1,0,1,0,0,0,0.0,0.0,0,0,0
f3270,net.sf.f3270.HostCharset,0,0,0,0,0,0.0,0.0,2,2,0,0,2,0,100.0,100.0,0,0,0
f3270,net.sf.f3270.FieldIdentifier,9,0,9,0,0,0.0,0.0,43,0,43,0,0,0,0.0,0.0,37,0,0.0
f3270,net.sf.f3270.TerminalScreenToConsoleObserver,4,0,4,0,0,0.0,0.0,24,0,24,0,0,0,0.0,0.0,10,0,0.0
f3270,net.sf.f3270.TrailObserver,0,0,0,0,0,0.0,0.0,0,0,0,0,0,0,0.0,0.0,0,0,0
f3270,net.sf.f3270.MatchMode,0,0,0,0,0,0.0,0.0,0,0,0,0,0,0,0.0,0.0,0,0,0
f3270,net.sf.f3270.Terminal,52,0,52,0,0,0.0,0.0,155,0,155,0,0,0,0.0,0.0,114,0,0.0
f3270,net.sf.f3270.TerminalModel,0,0,0,0,0,0.0,0.0,1,0,1,0,0,0,0.0,0.0,0,0,0
f3270,net.sf.f3270.Parameter,1,0,1,0,0,0.0,0.0,9,0,9,0,0,0,0.0,0.0,1,0,0.0
f3270,net.sf.f3270.TerminalObserver,0,0,0,0,0,0.0,0.0,0,0,0,0,0,0,0.0,0.0,0,0,0
f3270,net.sf.f3270.TerminalWindow,23,0,23,0,0,0.0,0.0,154,0,154,0,0,0,0.0,0.0,92,0,0.0
f3270,net.sf.f3270.TerminalWindowIde,7,0,7,0,0,0.0,0.0,39,0,39,0,0,0,0.0,0.0,17,0,0.0
f3270,net.sf.f3270.ide.Command,2,0,2,0,0,0.0,0.0,32,0,32,0,0,0,0.0,0.0,24,0,0.0
f3270,net.sf.f3270.ide.Ide,25,0,25,0,0,0.0,0.0,275,0,275,0,0,0,0.0,0.0,152,0,0.0
f3270,net.sf.f3270.junit.rules.UserCredentialsResource,2,2,0,1,1,100.0,50.0,22,8,14,1,7,0,36.36,31.82,8,0,0.0
f3270,net.sf.f3270.junit.rules.TerminalResource,4,0,4,0,0,0.0,0.0,12,0,12,0,0,0,0.0,0.0,5,0,0.0
f3270,org.h3270.host.Screen,0,0,0,0,0,0.0,0.0,0,0,0,0,0,0,0.0,0.0,0,0,0
f3270,org.h3270.host.Field,12,0,12,0,0,0.0,0.0,48,0,48,0,0,0,0.0,0.0,38,0,0.0
f3270,org.h3270.host.ScreenCharSequence,5,0,5,0,0,0.0,0.0,14,0,14,0,0,0,0.0,0.0,14,0,0.0
f3270,org.h3270.host.S3270Screen,6,0,6,0,0,0.0,0.0,129,0,129,0,0,0,0.0,0.0,52,0,0.0
f3270,org.h3270.host.AbstractScreen,9,0,9,0,0,0.0,0.0,64,0,64,0,0,0,0.0,0.0,55,0,0.0
f3270,org.h3270.host.HostUnreachableException,0,0,0,0,0,0.0,0.0,2,0,2,0,0,0,0.0,0.0,0,0,0
f3270,org.h3270.host.S3270,26,0,26,0,0,0.0,0.0,185,0,185,0,0,0,0.0,0.0,81,0,0.0
f3270,org.h3270.host.UnknownHostException,0,0,0,0,0,0.0,0.0,1,0,1,0,0,0,0.0,0.0,0,0,0
f3270,org.h3270.host.S3270$ErrorReader,1,0,1,0,0,0.0,0.0,7,0,7,0,0,0,0.0,0.0,1,0,0.0
f3270,org.h3270.host.InputField,6,0,6,0,0,0.0,0.0,40,0,40,0,0,0,0.0,0.0,23,0,0.0
f3270,org.h3270.host.S3270$Result,0,0,0,0,0,0.0,0.0,2,0,2,0,0,0,0.0,0.0,0,0,0
f3270,org.h3270.host.S3270Exception,0,0,0,0,0,0.0,0.0,0,0,0,0,0,0,0.0,0.0,0,0,0
f3270,org.h3270.render.TextRenderer,7,0,7,0,0,0.0,0.0,34,0,34,0,0,0,0.0,0.0,33,0,0.0
f3270,org.h3270.render.Renderer,0,0,0,0,0,0.0,0.0,0,0,0,0,0,0,0.0,0.0,0,0,0
f3270,org.h3270.render.TextRenderer$FieldSelector,0,0,0,0,0,0.0,0.0,0,0,0,0,0,0,0.0,0.0,0,0,0
chardet4j,com.sigpwned.chardet4j.Chardet,7,6,1,6,0,85.71,0.0,49,32,17,32,0,0,65.31,0.0,29,20,68.97
chardet4j,com.sigpwned.chardet4j.Chardet$ChardetMatch,5,2,3,2,0,40.0,0.0,23,6,17,6,0,0,26.09,0.0,14,3,21.43
chardet4j,com.sigpwned.chardet4j.ByteOrderMark,4,4,0,3,1,100.0,25.0,39,30,9,30,0,0,76.92,0.0,27,17,62.96
chardet4j,com.sigpwned.chardet4j.com.ibm.icu.text.CharsetRecog_mbcs$CharsetRecog_euc,1,1,0,0,1,100.0,100.0,5,5,0,5,0,0,100.0,0.0,22,0,0.0
chardet4j,com.sigpwned.chardet4j.com.ibm.icu.text.CharsetRecog_sbcs$CharsetRecog_8859_6,0,0,0,0,0,0.0,0.0,0,0,0,0,0,0,0.0,0.0,0,0,0
chardet4j,com.sigpwned.chardet4j.com.ibm.icu.text.CharsetRecog_Unicode$CharsetRecog_UTF_32_LE,1,1,0,1,0,100.0,0.0,1,1,0,1,0,0,100.0,0.0,15,9,60.0
chardet4j,com.sigpwned.chardet4j.com.ibm.icu.text.CharsetRecog_sbcs$NGramParser_IBM420,3,0,3,0,0,0.0,0.0,39,0,39,0,0,0,0.0,0.0,32,0,0.0
chardet4j,com.sigpwned.chardet4j.com.ibm.icu.text.CharsetRecog_2022$CharsetRecog_2022KR,1,1,0,0,1,100.0,100.0,2,2,0,2,0,0,100.0,0.0,2,0,0.0
chardet4j,com.sigpwned.chardet4j.com.ibm.icu.text.CharsetRecog_mbcs$CharsetRecog_euc$CharsetRecog_euc_kr,1,1,0,0,1,100.0,100.0,2,2,0,2,0,0,100.0,0.0,2,0,0.0
chardet4j,com.sigpwned.chardet4j.com.ibm.icu.text.CharsetRecog_sbcs$CharsetRecog_8859_8_he,1,1,0,0,1,100.0,100.0,3,3,0,3,0,0,100.0,0.0,3,0,0.0
chardet4j,com.sigpwned.chardet4j.com.ibm.icu.text.CharsetRecog_sbcs$CharsetRecog_KOI8_R,1,1,0,0,1,100.0,100.0,2,2,0,2,0,0,100.0,0.0,2,0,0.0
chardet4j,com.sigpwned.chardet4j.com.ibm.icu.text.CharsetRecog_sbcs$CharsetRecog_windows_1256,1,1,0,0,1,100.0,100.0,2,2,0,2,0,0,100.0,0.0,2,0,0.0
chardet4j,com.sigpwned.chardet4j.com.ibm.icu.text.CharsetRecognizer,0,0,0,0,0,0.0,0.0,0,0,0,0,0,0,0.0,0.0,0,0,0
chardet4j,com.sigpwned.chardet4j.com.ibm.icu.text.CharsetRecog_sbcs$CharsetRecog_IBM420_ar,0,0,0,0,0,0.0,0.0,0,0,0,0,0,0,0.0,0.0,0,0,0
chardet4j,com.sigpwned.chardet4j.com.ibm.icu.text.CharsetRecog_mbcs$CharsetRecog_big5,2,2,0,0,2,100.0,100.0,19,17,2,17,0,0,89.47,0.0,19,0,0.0
chardet4j,com.sigpwned.chardet4j.com.ibm.icu.text.CharsetRecog_mbcs$CharsetRecog_sjis,2,2,0,0,2,100.0,100.0,19,17,2,17,0,0,89.47,0.0,26,0,0.0
chardet4j,com.sigpwned.chardet4j.com.ibm.icu.text.CharsetRecog_sbcs$CharsetRecog_8859_7,0,0,0,0,0,0.0,0.0,0,0,0,0,0,0,0.0,0.0,0,0,0
chardet4j,com.sigpwned.chardet4j.com.ibm.icu.text.CharsetRecog_sbcs,3,2,1,2,0,66.67,0.0,5,3,2,3,0,0,60.0,0.0,3,2,66.67
chardet4j,com.sigpwned.chardet4j.com.ibm.icu.text.CharsetRecog_sbcs$CharsetRecog_8859_5_ru,1,1,0,0,1,100.0,100.0,2,2,0,2,0,0,100.0,0.0,2,0,0.0
chardet4j,com.sigpwned.chardet4j.com.ibm.icu.text.CharsetDetector$CSRecognizerInfo,0,0,0,0,0,0.0,0.0,2,0,2,0,0,0,0.0,0.0,0,0,0
chardet4j,com.sigpwned.chardet4j.com.ibm.icu.text.CharsetRecog_mbcs,1,1,0,0,1,100.0,100.0,8,8,0,8,0,0,100.0,0.0,40,0,0.0
chardet4j,com.sigpwned.chardet4j.com.ibm.icu.text.CharsetRecog_sbcs$CharsetRecog_windows_1251,1,1,0,0,1,100.0,100.0,2,2,0,2,0,0,100.0,0.0,2,0,0.0
chardet4j,com.sigpwned.chardet4j.com.ibm.icu.text.CharsetRecog_sbcs$CharsetRecog_IBM420_ar_rtl,1,0,1,0,0,0.0,0.0,2,0,2,0,0,0,0.0,0.0,2,0,0.0
chardet4j,com.sigpwned.chardet4j.com.ibm.icu.text.CharsetRecog_Unicode,2,2,0,2,0,100.0,0.0,14,8,6,8,0,0,57.14,0.0,18,12,66.67
chardet4j,com.sigpwned.chardet4j.com.ibm.icu.text.CharsetRecog_2022$CharsetRecog_2022CN,1,1,0,0,1,100.0,100.0,2,2,0,2,0,0,100.0,0.0,2,0,0.0
chardet4j,com.sigpwned.chardet4j.com.ibm.icu.text.CharsetRecog_sbcs$CharsetRecog_8859_1,1,1,0,1,0,100.0,0.0,10,10,0,10,0,0,100.0,0.0,6,4,66.67
chardet4j,com.sigpwned.chardet4j.com.ibm.icu.text.CharsetRecog_UTF8,1,1,0,1,0,100.0,0.0,59,47,12,47,0,0,79.66,0.0,47,22,46.81
chardet4j,com.sigpwned.chardet4j.com.ibm.icu.text.CharsetRecog_Unicode$CharsetRecog_UTF_16_LE,1,1,0,1,0,100.0,0.0,21,15,6,15,0,0,71.43,0.0,15,9,60.0
chardet4j,com.sigpwned.chardet4j.com.ibm.icu.text.CharsetRecog_sbcs$NGramParser,7,6,1,6,0,85.71,0.0,59,56,3,56,0,0,94.92,0.0,63,47,74.6
chardet4j,com.sigpwned.chardet4j.com.ibm.icu.text.CharsetRecog_sbcs$CharsetRecog_IBM420_ar_ltr,1,0,1,0,0,0.0,0.0,2,0,2,0,0,0,0.0,0.0,2,0,0.0
chardet4j,com.sigpwned.chardet4j.com.ibm.icu.text.CharsetRecog_2022$CharsetRecog_2022JP,1,1,0,0,1,100.0,100.0,2,2,0,2,0,0,100.0,0.0,2,0,0.0
chardet4j,com.sigpwned.chardet4j.com.ibm.icu.text.CharsetRecog_mbcs$CharsetRecog_euc$CharsetRecog_euc_jp,1,1,0,0,1,100.0,100.0,2,2,0,2,0,0,100.0,0.0,2,0,0.0
chardet4j,com.sigpwned.chardet4j.com.ibm.icu.text.CharsetRecog_Unicode$CharsetRecog_UTF_16_BE,1,1,0,1,0,100.0,0.0,21,15,6,15,0,0,71.43,0.0,15,9,60.0
chardet4j,com.sigpwned.chardet4j.com.ibm.icu.text.CharsetRecog_sbcs$CharsetRecog_8859_2,1,1,0,0,1,100.0,100.0,10,10,0,10,0,0,100.0,0.0,6,0,0.0
chardet4j,com.sigpwned.chardet4j.com.ibm.icu.text.CharsetRecog_sbcs$CharsetRecog_8859_9_tr,1,1,0,0,1,100.0,100.0,3,3,0,3,0,0,100.0,0.0,3,0,0.0
chardet4j,com.sigpwned.chardet4j.com.ibm.icu.text.CharsetRecog_mbcs$CharsetRecog_gb_18030,2,2,0,0,2,100.0,100.0,8,8,0,8,0,0,100.0,0.0,38,0,0.0
chardet4j,com.sigpwned.chardet4j.com.ibm.icu.text.CharsetRecog_sbcs$NGramsPlusLang,0,0,0,0,0,0.0,0.0,2,0,2,0,0,0,0.0,0.0,0,0,0
chardet4j,com.sigpwned.chardet4j.com.ibm.icu.text.CharsetRecog_mbcs$iteratedChar,2,2,0,1,1,100.0,50.0,10,10,0,10,0,0,100.0,0.0,6,2,33.33
chardet4j,com.sigpwned.chardet4j.com.ibm.icu.text.CharsetRecog_sbcs$CharsetRecog_8859_7_el,1,1,0,0,1,100.0,100.0,3,3,0,3,0,0,100.0,0.0,3,0,0.0
chardet4j,com.sigpwned.chardet4j.com.ibm.icu.text.CharsetRecog_sbcs$CharsetRecog_IBM424_he,0,0,0,0,0,0.0,0.0,0,0,0,0,0,0,0.0,0.0,0,0,0
chardet4j,com.sigpwned.chardet4j.com.ibm.icu.text.CharsetMatch,4,1,3,0,1,25.0,25.0,54,24,30,24,0,0,44.44,0.0,22,0,0.0
chardet4j,com.sigpwned.chardet4j.com.ibm.icu.text.CharsetRecog_sbcs$CharsetRecog_8859_6_ar,1,1,0,0,1,100.0,100.0,2,2,0,2,0,0,100.0,0.0,2,0,0.0
chardet4j,com.sigpwned.chardet4j.com.ibm.icu.text.CharsetRecog_sbcs$CharsetRecog_8859_8,0,0,0,0,0,0.0,0.0,0,0,0,0,0,0,0.0,0.0,0,0,0
chardet4j,com.sigpwned.chardet4j.com.ibm.icu.text.CharsetRecog_sbcs$CharsetRecog_IBM424_he_ltr,1,0,1,0,0,0.0,0.0,2,0,2,0,0,0,0.0,0.0,2,0,0.0
chardet4j,com.sigpwned.chardet4j.com.ibm.icu.text.CharsetRecog_sbcs$CharsetRecog_8859_8_I_he,1,1,0,0,1,100.0,100.0,3,3,0,3,0,0,100.0,0.0,3,0,0.0
chardet4j,com.sigpwned.chardet4j.com.ibm.icu.text.CharsetRecog_Unicode$CharsetRecog_UTF_32,1,1,0,0,1,100.0,100.0,35,20,15,20,0,0,57.14,0.0,33,5,15.15
chardet4j,com.sigpwned.chardet4j.com.ibm.icu.text.CharsetDetector,8,2,6,2,0,25.0,0.0,95,42,53,42,0,0,44.21,0.0,58,14,24.14
chardet4j,com.sigpwned.chardet4j.com.ibm.icu.text.CharsetRecog_sbcs$CharsetRecog_8859_9,0,0,0,0,0,0.0,0.0,0,0,0,0,0,0,0.0,0.0,0,0,0
chardet4j,com.sigpwned.chardet4j.com.ibm.icu.text.CharsetRecog_2022,1,1,0,0,1,100.0,100.0,34,9,25,9,0,0,26.47,0.0,35,2,5.71
chardet4j,com.sigpwned.chardet4j.com.ibm.icu.text.CharsetRecog_Unicode$CharsetRecog_UTF_32_BE,1,1,0,1,0,100.0,0.0,1,1,0,1,0,0,100.0,0.0,15,9,60.0
chardet4j,com.sigpwned.chardet4j.com.ibm.icu.text.CharsetRecog_sbcs$CharsetRecog_8859_5,0,0,0,0,0,0.0,0.0,0,0,0,0,0,0,0.0,0.0,0,0,0
chardet4j,com.sigpwned.chardet4j.com.ibm.icu.text.CharsetRecog_sbcs$CharsetRecog_IBM424_he_rtl,1,0,1,0,0,0.0,0.0,2,0,2,0,0,0,0.0,0.0,2,0,0.0
marine,examples.HelloWorld,1,0,1,0,0,0.0,0.0,7,0,7,0,0,0,0.0,0.0,0,0,0
marine,com.harium.marine.Web,13,2,11,0,2,15.38,15.38,38,2,36,0,2,0,5.26,5.26,27,0,0.0
marine,com.harium.marine.model.WebModule,0,0,0,0,0,0.0,0.0,0,0,0,0,0,0,0.0,0.0,0,0,0
marine,com.harium.marine.model.ResponseModel,0,0,0,0,0,0.0,0.0,0,0,0,0,0,0,0.0,0.0,0,0,0
authlete-jose,com.authlete.jose.tool.JoseGenerator,39,29,10,22,7,74.36,17.95,497,268,229,268,0,0,53.92,0.0,272,129,47.43
authlete-jose,com.authlete.jose.tool.JoseGeneratorOptions,0,0,0,0,0,0.0,0.0,0,0,0,0,0,0,0.0,0.0,0,0,0
authlete-jose,com.authlete.jose.tool.BasicOptionsParser,1,1,0,1,0,100.0,0.0,3,3,0,3,0,0,100.0,0.0,2,2,100.0
authlete-jose,com.authlete.jose.tool.Support,4,2,2,0,2,50.0,50.0,35,13,22,13,0,0,37.14,0.0,22,6,27.27
authlete-jose,com.authlete.jose.tool.converter.JWKConverter,1,1,0,1,0,100.0,0.0,1,1,0,1,0,0,100.0,0.0,1,1,100.0
authlete-jose,com.authlete.jose.tool.converter.JWEHeaderBase64UrlConverter,1,0,1,0,0,0.0,0.0,1,0,1,0,0,0,0.0,0.0,1,0,0.0
authlete-jose,com.authlete.jose.tool.converter.URIConverter,1,0,1,0,0,0.0,0.0,1,0,1,0,0,0,0.0,0.0,1,0,0.0
authlete-jose,com.authlete.jose.tool.converter.JWSAlgorithmConverter,1,1,0,1,0,100.0,0.0,1,1,0,1,0,0,100.0,0.0,1,1,100.0
authlete-jose,com.authlete.jose.tool.converter.FileConverter,1,0,1,0,0,0.0,0.0,1,0,1,0,0,0,0.0,0.0,1,0,0.0
authlete-jose,com.authlete.jose.tool.converter.SupportedEncryptionMethodConverter,1,0,1,0,0,0.0,0.0,6,0,6,0,0,0,0.0,0.0,2,0,0.0
authlete-jose,com.authlete.jose.tool.converter.SupportedJWEAlgorithmConverter,1,0,1,0,0,0.0,0.0,6,0,6,0,0,0,0.0,0.0,2,0,0.0
authlete-jose,com.authlete.jose.tool.converter.SupportedJWSAlgorithmConverter,1,1,0,1,0,100.0,0.0,6,4,2,4,0,0,66.67,0.0,2,2,100.0
authlete-jose,com.authlete.jose.tool.converter.JWSHeaderConverter,1,1,0,1,0,100.0,0.0,1,1,0,1,0,0,100.0,0.0,1,1,100.0
authlete-jose,com.authlete.jose.tool.converter.JWEHeaderConverter,1,0,1,0,0,0.0,0.0,1,0,1,0,0,0,0.0,0.0,1,0,0.0
authlete-jose,com.authlete.jose.tool.converter.EncryptionMethodConverter,1,0,1,0,0,0.0,0.0,1,0,1,0,0,0,0.0,0.0,1,0,0.0
authlete-jose,com.authlete.jose.tool.converter.JWEAlgorithmConverter,1,0,1,0,0,0.0,0.0,1,0,1,0,0,0,0.0,0.0,1,0,0.0
authlete-jose,com.authlete.jose.tool.converter.JWKSetConverter,1,1,0,1,0,100.0,0.0,1,1,0,1,0,0,100.0,0.0,1,1,100.0
authlete-jose,com.authlete.jose.tool.converter.BaseConverter,1,1,0,1,0,100.0,0.0,5,3,2,3,0,0,60.0,0.0,1,1,100.0
authlete-jose,com.authlete.jose.tool.converter.Base64UrlConverter,1,1,0,1,0,100.0,0.0,1,1,0,1,0,0,100.0,0.0,1,1,100.0
authlete-jose,com.authlete.jose.tool.converter.JWSHeaderBase64UrlConverter,1,1,0,1,0,100.0,0.0,1,1,0,1,0,0,100.0,0.0,1,1,100.0
smartbill-java-client,com.github.smartbillclient4j.SmartBillClient,10,1,9,1,0,10.0,0.0,158,27,131,27,0,0,17.09,0.0,25,1,4.0
smartbill-java-client,com.github.smartbillclient4j.Warehouse,1,0,1,0,0,0.0,0.0,1,0,1,0,0,0,0.0,0.0,1,0,0.0
smartbill-java-client,com.github.smartbillclient4j.Warehouse$Type,0,0,0,0,0,0.0,0.0,0,0,0,0,0,0,0.0,0.0,0,0,0
smartbill-java-client,com.github.smartbillclient4j.Stock,0,0,0,0,0,0.0,0.0,0,0,0,0,0,0,0.0,0.0,0,0,0
smartbill-java-client,com.github.smartbillclient4j.DocumentType,0,0,0,0,0,0.0,0.0,0,0,0,0,0,0,0.0,0.0,0,0,0
smartbill-java-client,com.github.smartbillclient4j.SeriesInfo,1,0,1,0,0,0.0,0.0,4,0,4,0,0,0,0.0,0.0,1,0,0.0
smartbill-java-client,com.github.smartbillclient4j.SmartBillException,1,1,0,1,0,100.0,0.0,34,18,16,5,13,12,52.94,38.24,3,0,0.0
smartbill-java-client,com.github.smartbillclient4j.StockResponse,0,0,0,0,0,0.0,0.0,0,0,0,0,0,0,0.0,0.0,0,0,0
smartbill-java-client,com.github.smartbillclient4j.TaxResponse,0,0,0,0,0,0.0,0.0,0,0,0,0,0,0,0.0,0.0,0,0,0
smartbill-java-client,com.github.smartbillclient4j.Response,1,0,1,0,0,0.0,0.0,1,0,1,0,0,0,0.0,0.0,1,0,0.0
smartbill-java-client,com.github.smartbillclient4j.Product,1,0,1,0,0,0.0,0.0,1,0,1,0,0,0,0.0,0.0,1,0,0.0
smartbill-java-client,com.github.smartbillclient4j.Tax,1,0,1,0,0,0.0,0.0,1,0,1,0,0,0,0.0,0.0,1,0,0.0
kafka-common-lib,com.rbkmoney.kafka.common.retry.SimpleRetryContext,0,0,0,0,0,0.0,0.0,0,0,0,0,0,0,0.0,0.0,0,0,0
kafka-common-lib,com.rbkmoney.kafka.common.retry.ConfigurableRetryPolicy,5,2,3,2,0,40.0,0.0,9,6,3,5,1,0,66.67,11.11,12,7,58.33
kafka-common-lib,com.rbkmoney.kafka.common.util.LogUtil,6,0,6,0,0,0.0,0.0,29,0,29,0,0,0,0.0,0.0,14,0,0.0
kafka-common-lib,com.rbkmoney.kafka.common.serialization.AbstractThriftDeserializer,4,1,3,1,0,25.0,0.0,9,3,6,3,0,0,33.33,0.0,6,2,33.33
kafka-common-lib,com.rbkmoney.kafka.common.serialization.ThriftSerializer,3,1,2,1,0,33.33,0.0,8,3,5,2,1,1,37.5,12.5,2,1,50.0
kafka-common-lib,com.rbkmoney.kafka.common.loader.PreloadListenerImpl,4,4,0,2,2,100.0,50.0,43,37,6,36,1,1,86.05,2.33,22,8,36.36
kafka-common-lib,com.rbkmoney.kafka.common.loader.PreloadListener,0,0,0,0,0,0.0,0.0,0,0,0,0,0,0,0.0,0.0,0,0,0
kafka-common-lib,com.rbkmoney.kafka.common.exception.SkippedException,0,0,0,0,0,0.0,0.0,0,0,0,0,0,0,0.0,0.0,0,0,0
kafka-common-lib,com.rbkmoney.kafka.common.exception.KafkaProduceException,0,0,0,0,0,0.0,0.0,0,0,0,0,0,0,0.0,0.0,0,0,0
kafka-common-lib,com.rbkmoney.kafka.common.exception.KafkaSerializationException,0,0,0,0,0,0.0,0.0,0,0,0,0,0,0,0.0,0.0,0,0,0
kafka-common-lib,com.rbkmoney.kafka.common.exception.RetryableException,0,0,0,0,0,0.0,0.0,0,0,0,0,0,0,0.0,0.0,0,0,0
kafka-common-lib,com.rbkmoney.kafka.common.exception.handler.SeekToCurrentWithSleepErrorHandler,2,0,2,0,0,0.0,0.0,10,0,10,0,0,0,0.0,0.0,4,0,0.0
kafka-common-lib,com.rbkmoney.kafka.common.exception.handler.SeekToCurrentWithSleepBatchErrorHandler,3,0,3,0,0,0.0,0.0,9,0,9,0,0,0,0.0,0.0,6,0,0.0
coodoo-listing,io.coodoo.framework.listing.boundary.ListingResult,1,0,1,0,0,0.0,0.0,7,0,7,0,0,0,0.0,0.0,1,0,0.0
coodoo-listing,io.coodoo.framework.listing.boundary.Term,1,0,1,0,0,0.0,0.0,16,0,16,0,0,0,0.0,0.0,1,0,0.0
coodoo-listing,io.coodoo.framework.listing.boundary.ListingParameters,13,8,5,8,0,61.54,0.0,76,32,44,32,0,0,42.11,0.0,57,37,64.91
coodoo-listing,io.coodoo.framework.listing.boundary.Metadata,1,0,1,0,0,0.0,0.0,29,24,5,24,0,0,82.76,0.0,1,0,0.0
coodoo-listing,io.coodoo.framework.listing.boundary.Listing,11,0,11,0,0,0.0,0.0,16,0,16,0,0,0,0.0,0.0,17,0,0.0
coodoo-listing,io.coodoo.framework.listing.boundary.ListingPredicate,6,0,6,0,0,0.0,0.0,23,0,23,0,0,0,0.0,0.0,11,0,0.0
coodoo-listing,io.coodoo.framework.listing.boundary.Stats,1,0,1,0,0,0.0,0.0,1,0,1,0,0,0,0.0,0.0,1,0,0.0
coodoo-listing,io.coodoo.framework.listing.control.ListingQuery,18,0,18,0,0,0.0,0.0,418,0,418,0,0,0,0.0,0.0,219,0,0.0
coodoo-listing,io.coodoo.framework.listing.control.ListingUtil,24,1,23,1,0,4.17,0.0,89,43,46,41,2,2,48.31,2.25,68,22,32.35
coodoo-listing,io.coodoo.framework.listing.control.ListingConfig,5,0,5,0,0,0.0,0.0,64,0,64,0,0,0,0.0,0.0,17,0,0.0
jena.serializer,org.apache.clerezza.rdf.jena.serializer.JenaSerializerProvider,2,2,0,2,0,100.0,0.0,32,28,4,28,0,0,87.5,0.0,17,13,76.47
jargser,me.mervinz.jargser.Command,0,0,0,0,0,0.0,0.0,2,2,0,2,0,0,100.0,0.0,0,0,0
jargser,me.mervinz.jargser.Option,1,1,0,0,1,100.0,100.0,7,7,0,7,0,0,100.0,0.0,7,6,85.71
jargser,me.mervinz.jargser.ArgumentParser,9,7,2,5,2,77.78,22.22,87,74,13,74,0,0,85.06,0.0,50,23,46.0
beanunit,nl.ivonet.beanunit.ConstructedBeanAsserter,6,6,0,5,1,100.0,16.67,42,35,7,31,4,2,83.33,9.52,31,14,45.16
beanunit,nl.ivonet.beanunit.PojoContractAsserter,8,8,0,6,2,100.0,25.0,87,52,35,21,31,25,59.77,35.63,56,22,39.29
beanunit,nl.ivonet.beanunit.BuilderBeanAsserter,20,19,1,9,10,95.0,50.0,104,78,26,63,15,4,75.0,14.42,73,30,41.1
beanunit,nl.ivonet.beanunit.Asserter,10,8,2,6,2,80.0,20.0,42,23,19,23,0,0,54.76,0.0,23,9,39.13
beanunit,nl.ivonet.beanunit.Asserter$OtherType,0,0,0,0,0,0.0,0.0,0,0,0,0,0,0,0.0,0.0,0,0,0
commons-csv,org.apache.commons.csv.CSVRecord,17,17,0,17,0,100.0,0.0,34,34,0,34,0,0,100.0,0.0,38,36,94.74
commons-csv,org.apache.commons.csv.Constants,0,0,0,0,0,0.0,0.0,0,0,0,0,0,0,0.0,0.0,0,0,0
commons-csv,org.apache.commons.csv.DuplicateHeaderMode,0,0,0,0,0,0.0,0.0,0,0,0,0,0,0,0.0,0.0,0,0,0
commons-csv,org.apache.commons.csv.Token$Type,0,0,0,0,0,0.0,0.0,0,0,0,0,0,0,0.0,0.0,0,0,0
commons-csv,org.apache.commons.csv.CSVFormat$Predefined,0,0,0,0,0,0.0,0.0,1,1,0,0,1,0,100.0,100.0,0,0,0
commons-csv,org.apache.commons.csv.Token,2,2,0,2,0,100.0,0.0,5,5,0,5,0,0,100.0,0.0,2,2,100.0
commons-csv,org.apache.commons.csv.Lexer,19,19,0,19,0,100.0,0.0,202,202,0,202,0,0,100.0,0.0,118,109,92.37
commons-csv,org.apache.commons.csv.QuoteMode,0,0,0,0,0,0.0,0.0,0,0,0,0,0,0,0.0,0.0,0,0,0
commons-csv,org.apache.commons.csv.ExtendedBufferedReader,9,9,0,8,1,100.0,11.11,58,58,0,58,0,0,100.0,0.0,54,50,92.59
commons-csv,org.apache.commons.csv.CSVFormat$Builder,7,7,0,7,0,100.0,0.0,38,38,0,38,0,0,100.0,0.0,15,15,100.0
commons-csv,org.apache.commons.csv.CSVParser$CSVRecordIterator,4,4,0,4,0,100.0,0.0,23,23,0,23,0,0,100.0,0.0,10,10,100.0
commons-csv,org.apache.commons.csv.CSVFormat,43,43,0,43,0,100.0,0.0,381,371,10,368,3,2,97.38,0.79,229,208,90.83
commons-csv,org.apache.commons.csv.CSVPrinter,16,16,0,16,0,100.0,0.0,74,74,0,74,0,0,100.0,0.0,49,47,95.92
commons-csv,org.apache.commons.csv.IOUtils,5,5,0,5,0,100.0,0.0,16,16,0,16,0,0,100.0,0.0,9,3,33.33
commons-csv,org.apache.commons.csv.CSVParser,23,23,0,23,0,100.0,0.0,126,124,2,124,0,0,98.41,0.0,77,76,98.7
commons-csv,org.apache.commons.csv.CSVParser$Headers,0,0,0,0,0,0.0,0.0,2,2,0,2,0,0,100.0,0.0,0,0,0
solr-cmd-utils,de.tblsoft.solr.cmd.PipelineArgs,0,0,0,0,0,0.0,0.0,0,0,0,0,0,0,0.0,0.0,0,0,0
solr-cmd-utils,de.tblsoft.solr.cmd.Cmd,21,0,21,0,0,0.0,0.0,304,0,304,0,0,0,0.0,0.0,161,0,0.0
solr-cmd-utils,de.tblsoft.solr.cmd.SolrArgs,5,0,5,0,0,0.0,0.0,5,0,5,0,0,0,0.0,0.0,10,0,0.0
solr-cmd-utils,de.tblsoft.solr.cmd.Pipeline,1,0,1,0,0,0.0,0.0,13,0,13,0,0,0,0.0,0.0,5,0,0.0
solr-cmd-utils,de.tblsoft.solr.pipeline.ReaderIF,0,0,0,0,0,0.0,0.0,0,0,0,0,0,0,0.0,0.0,0,0,0
solr-cmd-utils,de.tblsoft.solr.pipeline.FilelineReader,1,0,1,0,0,0.0,0.0,30,0,30,0,0,0,0.0,0.0,9,0,0.0
solr-cmd-utils,de.tblsoft.solr.pipeline.DocumentGeneratorReader,1,0,1,0,0,0.0,0.0,9,0,9,0,0,0,0.0,0.0,6,0,0.0
solr-cmd-utils,de.tblsoft.solr.pipeline.RandomReader,1,0,1,0,0,0.0,0.0,10,0,10,0,0,0,0.0,0.0,4,0,0.0
solr-cmd-utils,de.tblsoft.solr.pipeline.FileLineWriter,5,0,5,0,0,0.0,0.0,31,0,31,0,0,0,0.0,0.0,10,0,0.0
solr-cmd-utils,de.tblsoft.solr.pipeline.GrokReader,2,2,0,2,0,100.0,0.0,51,41,10,40,1,1,80.39,1.96,16,12,75.0
solr-cmd-utils,de.tblsoft.solr.pipeline.ProcessorIF,0,0,0,0,0,0.0,0.0,0,0,0,0,0,0,0.0,0.0,0,0,0
solr-cmd-utils,de.tblsoft.solr.pipeline.ThreadDumpReader,12,0,12,0,0,0.0,0.0,119,0,119,0,0,0,0.0,0.0,54,0,0.0
solr-cmd-utils,de.tblsoft.solr.pipeline.StandardReader,7,0,7,0,0,0.0,0.0,34,0,34,0,0,0,0.0,0.0,12,0,0.0
solr-cmd-utils,de.tblsoft.solr.pipeline.XmlReader,2,2,0,2,0,100.0,0.0,47,44,3,42,2,2,93.62,4.26,13,11,84.62
solr-cmd-utils,de.tblsoft.solr.pipeline.ElasticJsonPathReader,1,0,1,0,0,0.0,0.0,30,0,30,0,0,0,0.0,0.0,3,0,0.0
solr-cmd-utils,de.tblsoft.solr.pipeline.QSFDataReader,1,0,1,0,0,0.0,0.0,20,0,20,0,0,0,0.0,0.0,2,0,0.0
solr-cmd-utils,de.tblsoft.solr.pipeline.RestReader,2,0,2,0,0,0.0,0.0,35,0,35,0,0,0,0.0,0.0,8,0,0.0
solr-cmd-utils,de.tblsoft.solr.pipeline.AbstractFilter,19,15,4,11,4,78.95,21.05,86,56,30,56,0,0,65.12,0.0,45,29,64.44
solr-cmd-utils,de.tblsoft.solr.pipeline.OpenThesaurusReader,3,0,3,0,0,0.0,0.0,25,0,25,0,0,0,0.0,0.0,10,0,0.0
solr-cmd-utils,de.tblsoft.solr.pipeline.JsonReader,2,0,2,0,0,0.0,0.0,23,0,23,0,0,0,0.0,0.0,2,0,0.0
solr-cmd-utils,de.tblsoft.solr.pipeline.JdbcReader,1,0,1,0,0,0.0,0.0,53,0,53,0,0,0,0.0,0.0,20,0,0.0
solr-cmd-utils,de.tblsoft.solr.pipeline.FilterIF,0,0,0,0,0,0.0,0.0,0,0,0,0,0,0,0.0,0.0,0,0,0
solr-cmd-utils,de.tblsoft.solr.pipeline.PipelineSaxContentHandler,3,3,0,3,0,100.0,0.0,17,17,0,17,0,0,100.0,0.0,6,6,100.0
solr-cmd-utils,de.tblsoft.solr.pipeline.SolrQueryLogReader,5,0,5,0,0,0.0,0.0,73,0,73,0,0,0,0.0,0.0,32,0,0.0
solr-cmd-utils,de.tblsoft.solr.pipeline.ElasticdumpJsonReader,6,4,2,4,0,66.67,0.0,69,28,41,28,0,0,40.58,0.0,26,12,46.15
solr-cmd-utils,de.tblsoft.solr.pipeline.JsonPathReader,5,0,5,0,0,0.0,0.0,48,0,48,0,0,0,0.0,0.0,14,0,0.0
solr-cmd-utils,de.tblsoft.solr.pipeline.DocumentWriter,3,0,3,0,0,0.0,0.0,24,0,24,0,0,0,0.0,0.0,6,0,0.0
solr-cmd-utils,de.tblsoft.solr.pipeline.CSVReader,2,2,0,2,0,100.0,0.0,71,53,18,53,0,0,74.65,0.0,21,14,66.67
solr-cmd-utils,de.tblsoft.solr.pipeline.DocumentReader,4,3,1,3,0,75.0,0.0,26,19,7,19,0,0,73.08,0.0,8,6,75.0
solr-cmd-utils,de.tblsoft.solr.pipeline.XmlSitemapReader,6,0,6,0,0,0.0,0.0,82,0,82,0,0,0,0.0,0.0,31,0,0.0
solr-cmd-utils,de.tblsoft.solr.pipeline.DocumentDiffer,2,2,0,2,0,100.0,0.0,37,31,6,31,0,0,83.78,0.0,22,13,59.09
solr-cmd-utils,de.tblsoft.solr.pipeline.NetbaseReader,4,0,4,0,0,0.0,0.0,35,0,35,0,0,0,0.0,0.0,10,0,0.0
solr-cmd-utils,de.tblsoft.solr.pipeline.ElasticReader,1,0,1,0,0,0.0,0.0,25,0,25,0,0,0,0.0,0.0,7,0,0.0
solr-cmd-utils,de.tblsoft.solr.pipeline.PipelineExecuter,16,15,1,13,2,93.75,12.5,162,128,34,121,7,6,79.01,4.32,64,40,62.5
solr-cmd-utils,de.tblsoft.solr.pipeline.Lookup,2,0,2,0,0,0.0,0.0,11,0,11,0,0,0,0.0,0.0,4,0,0.0
solr-cmd-utils,de.tblsoft.solr.pipeline.HtmlFileReader,1,0,1,0,0,0.0,0.0,10,0,10,0,0,0,0.0,0.0,2,0,0.0
solr-cmd-utils,de.tblsoft.solr.pipeline.GraphQLReader,8,0,8,0,0,0.0,0.0,91,0,91,0,0,0,0.0,0.0,24,0,0.0
solr-cmd-utils,de.tblsoft.solr.pipeline.GCLogReader,2,0,2,0,0,0.0,0.0,35,0,35,0,0,0,0.0,0.0,13,0,0.0
solr-cmd-utils,de.tblsoft.solr.pipeline.AbstractProcessor,6,0,6,0,0,0.0,0.0,38,0,38,0,0,0,0.0,0.0,22,0,0.0
solr-cmd-utils,de.tblsoft.solr.pipeline.AbstractReader,6,6,0,6,0,100.0,0.0,40,36,4,36,0,0,90.0,0.0,20,16,80.0
solr-cmd-utils,de.tblsoft.solr.pipeline.reader.Bucket,0,0,0,0,0,0.0,0.0,0,0,0,0,0,0,0.0,0.0,0,0,0
solr-cmd-utils,de.tblsoft.solr.pipeline.reader.ElasticFacetReader,1,1,0,1,0,100.0,0.0,19,16,3,16,0,0,84.21,0.0,4,4,100.0
solr-cmd-utils,de.tblsoft.solr.pipeline.test.AbstractFilterTest,12,12,0,9,3,100.0,25.0,44,44,0,44,0,0,100.0,0.0,29,19,65.52
solr-cmd-utils,de.tblsoft.solr.pipeline.test.AbstractPipelineTest,1,1,0,1,0,100.0,0.0,4,4,0,4,0,0,100.0,0.0,1,1,100.0
solr-cmd-utils,de.tblsoft.solr.pipeline.test.AbstractBaseTest,11,8,3,0,8,72.73,72.73,31,18,13,18,0,0,58.06,0.0,17,2,11.76
solr-cmd-utils,de.tblsoft.solr.pipeline.bean.FieldComperator,1,1,0,0,1,100.0,100.0,1,1,0,1,0,0,100.0,0.0,1,0,0.0
solr-cmd-utils,de.tblsoft.solr.pipeline.bean.Filter,3,3,0,2,1,100.0,33.33,5,5,0,4,1,0,100.0,20.0,1,0,0.0
solr-cmd-utils,de.tblsoft.solr.pipeline.bean.Field,5,2,3,1,1,40.0,20.0,45,11,34,10,1,0,24.44,2.22,22,4,18.18
solr-cmd-utils,de.tblsoft.solr.pipeline.bean.FiltersPipeline,0,0,0,0,0,0.0,0.0,0,0,0,0,0,0,0.0,0.0,0,0,0
solr-cmd-utils,de.tblsoft.solr.pipeline.bean.FieldDiff$DiffType,0,0,0,0,0,0.0,0.0,0,0,0,0,0,0,0.0,0.0,0,0,0
solr-cmd-utils,de.tblsoft.solr.pipeline.bean.FieldDiff,0,0,0,0,0,0.0,0.0,0,0,0,0,0,0,0.0,0.0,0,0,0
solr-cmd-utils,de.tblsoft.solr.pipeline.bean.Processor,1,0,1,0,0,0.0,0.0,1,0,1,0,0,0,0.0,0.0,1,0,0.0
solr-cmd-utils,de.tblsoft.solr.pipeline.bean.Reader,1,0,1,0,0,0.0,0.0,1,0,1,0,0,0,0.0,0.0,1,0,0.0
solr-cmd-utils,de.tblsoft.solr.pipeline.bean.Document,26,18,8,16,2,69.23,7.69,121,73,48,72,1,0,60.33,0.83,63,30,47.62
solr-cmd-utils,de.tblsoft.solr.pipeline.bean.DocumentComparator,1,1,0,1,0,100.0,0.0,33,15,18,15,0,0,45.45,0.0,19,7,36.84
solr-cmd-utils,de.tblsoft.solr.pipeline.bean.ElasticResponse,0,0,0,0,0,0.0,0.0,0,0,0,0,0,0,0.0,0.0,0,0,0
solr-cmd-utils,de.tblsoft.solr.pipeline.bean.SolrUrl,1,0,1,0,0,0.0,0.0,9,0,9,0,0,0,0.0,0.0,1,0,0.0
solr-cmd-utils,de.tblsoft.solr.pipeline.bean.ElasticBulkResponse,0,0,0,0,0,0.0,0.0,0,0,0,0,0,0,0.0,0.0,0,0,0
solr-cmd-utils,de.tblsoft.solr.pipeline.bean.DocumentBuilder,2,2,0,2,0,100.0,0.0,2,2,0,2,0,0,100.0,0.0,2,2,100.0
solr-cmd-utils,de.tblsoft.solr.pipeline.bean.Pipeline,1,0,1,0,0,0.0,0.0,1,0,1,0,0,0,0.0,0.0,1,0,0.0
solr-cmd-utils,de.tblsoft.solr.pipeline.bean.DocumentDiff,0,0,0,0,0,0.0,0.0,0,0,0,0,0,0,0.0,0.0,0,0,0
solr-cmd-utils,de.tblsoft.solr.pipeline.processor.DownloadResourcesProcessor,2,0,2,0,0,0.0,0.0,19,0,19,0,0,0,0.0,0.0,5,0,0.0
solr-cmd-utils,de.tblsoft.solr.pipeline.processor.QSFDataRepositoryUploadProcessor,1,0,1,0,0,0.0,0.0,11,0,11,0,0,0,0.0,0.0,1,0,0.0
solr-cmd-utils,de.tblsoft.solr.pipeline.processor.OpenNLPPosTaggerTrainProcessor,2,0,2,0,0,0.0,0.0,14,0,14,0,0,0,0.0,0.0,3,0,0.0
solr-cmd-utils,de.tblsoft.solr.pipeline.processor.LineProcessor,2,0,2,0,0,0.0,0.0,24,0,24,0,0,0,0.0,0.0,8,0,0.0
solr-cmd-utils,de.tblsoft.solr.pipeline.processor.CountCharInLineProcessor,2,0,2,0,0,0.0,0.0,11,0,11,0,0,0,0.0,0.0,7,0,0.0
solr-cmd-utils,de.tblsoft.solr.pipeline.processor.FunctionFactory,1,0,1,0,0,0.0,0.0,5,0,5,0,0,0,0.0,0.0,2,0,0.0
solr-cmd-utils,de.tblsoft.solr.pipeline.processor.DistinctFunction,1,0,1,0,0,0.0,0.0,1,0,1,0,0,0,0.0,0.0,1,0,0.0
solr-cmd-utils,de.tblsoft.solr.pipeline.processor.Json2SingleDocumentsProcessor,1,0,1,0,0,0.0,0.0,19,0,19,0,0,0,0.0,0.0,2,0,0.0
solr-cmd-utils,de.tblsoft.solr.pipeline.processor.NoopProcessor,0,0,0,0,0,0.0,0.0,0,0,0,0,0,0,0.0,0.0,0,0,0
solr-cmd-utils,de.tblsoft.solr.pipeline.processor.TestProcessor,1,0,1,0,0,0.0,0.0,1,0,1,0,0,0,0.0,0.0,0,0,0
solr-cmd-utils,de.tblsoft.solr.pipeline.processor.ListDiffProcessor,2,0,2,0,0,0.0,0.0,30,0,30,0,0,0,0.0,0.0,6,0,0.0
solr-cmd-utils,de.tblsoft.solr.pipeline.nlp.squad.SquadReader,1,1,0,1,0,100.0,0.0,14,13,1,13,0,0,92.86,0.0,3,2,66.67
solr-cmd-utils,de.tblsoft.solr.pipeline.nlp.squad.SquadWriter,3,3,0,3,0,100.0,0.0,16,14,2,14,0,0,87.5,0.0,5,3,60.0
solr-cmd-utils,de.tblsoft.solr.pipeline.nlp.squad.AbstractSquadFilter,1,1,0,1,0,100.0,0.0,4,4,0,4,0,0,100.0,0.0,2,0,0.0
solr-cmd-utils,de.tblsoft.solr.pipeline.nlp.squad.dto.Squad,0,0,0,0,0,0.0,0.0,0,0,0,0,0,0,0.0,0.0,0,0,0
solr-cmd-utils,de.tblsoft.solr.pipeline.nlp.squad.dto.Paragraph,0,0,0,0,0,0.0,0.0,0,0,0,0,0,0,0.0,0.0,0,0,0
solr-cmd-utils,de.tblsoft.solr.pipeline.nlp.squad.dto.Qas,0,0,0,0,0,0.0,0.0,0,0,0,0,0,0,0.0,0.0,0,0,0
solr-cmd-utils,de.tblsoft.solr.pipeline.nlp.squad.dto.Data,0,0,0,0,0,0.0,0.0,0,0,0,0,0,0,0.0,0.0,0,0,0
solr-cmd-utils,de.tblsoft.solr.pipeline.nlp.squad.dto.Answer,0,0,0,0,0,0.0,0.0,0,0,0,0,0,0,0.0,0.0,0,0,0
solr-cmd-utils,de.tblsoft.solr.pipeline.filter.RoundNumberFilter,2,0,2,0,0,0.0,0.0,17,0,17,0,0,0,0.0,0.0,7,0,0.0
solr-cmd-utils,de.tblsoft.solr.pipeline.filter.StatusTimeFilter,2,0,2,0,0,0.0,0.0,9,0,9,0,0,0,0.0,0.0,7,0,0.0
solr-cmd-utils,de.tblsoft.solr.pipeline.filter.PostDataFilter,2,0,2,0,0,0.0,0.0,10,0,10,0,0,0,0.0,0.0,2,0,0.0
solr-cmd-utils,de.tblsoft.solr.pipeline.filter.ExternalFilter,5,0,5,0,0,0.0,0.0,48,0,48,0,0,0,0.0,0.0,18,0,0.0
solr-cmd-utils,de.tblsoft.solr.pipeline.filter.RegexFindFilter,2,2,0,2,0,100.0,0.0,19,17,2,17,0,0,89.47,0.0,9,6,66.67
solr-cmd-utils,de.tblsoft.solr.pipeline.filter.BaseBlacklistFilter,1,0,1,0,0,0.0,0.0,27,0,27,0,0,0,0.0,0.0,5,0,0.0
solr-cmd-utils,de.tblsoft.solr.pipeline.filter.DuplicateRemovalFilter,3,3,0,3,0,100.0,0.0,14,14,0,14,0,0,100.0,0.0,7,6,85.71
solr-cmd-utils,de.tblsoft.solr.pipeline.filter.MessageDigestFilter,4,4,0,4,0,100.0,0.0,24,23,1,23,0,0,95.83,0.0,9,8,88.89
solr-cmd-utils,de.tblsoft.solr.pipeline.filter.MappingFilter,5,5,0,3,2,100.0,40.0,74,65,9,65,0,0,87.84,0.0,22,12,54.55
solr-cmd-utils,de.tblsoft.solr.pipeline.filter.EntityExtractionFilter,7,0,7,0,0,0.0,0.0,105,0,105,0,0,0,0.0,0.0,37,0,0.0
solr-cmd-utils,de.tblsoft.solr.pipeline.filter.LinkCheckerFilter,2,2,0,2,0,100.0,0.0,39,29,10,29,0,0,74.36,0.0,30,14,46.67
solr-cmd-utils,de.tblsoft.solr.pipeline.filter.AddStaticValueFilter,2,0,2,0,0,0.0,0.0,11,0,11,0,0,0,0.0,0.0,5,0,0.0
solr-cmd-utils,de.tblsoft.solr.pipeline.filter.NoopFilter,0,0,0,0,0,0.0,0.0,0,0,0,0,0,0,0.0,0.0,0,0,0
solr-cmd-utils,de.tblsoft.solr.pipeline.filter.StatusFilter,2,0,2,0,0,0.0,0.0,6,0,6,0,0,0,0.0,0.0,5,0,0.0
solr-cmd-utils,de.tblsoft.solr.pipeline.filter.SplashFilter,2,0,2,0,0,0.0,0.0,21,0,21,0,0,0,0.0,0.0,3,0,0.0
solr-cmd-utils,de.tblsoft.solr.pipeline.filter.EntityExtractionFilter$Entity,1,0,1,0,0,0.0,0.0,3,0,3,0,0,0,0.0,0.0,1,0,0.0
solr-cmd-utils,de.tblsoft.solr.pipeline.filter.FieldSplitter,3,3,0,3,0,100.0,0.0,24,24,0,24,0,0,100.0,0.0,8,7,87.5
solr-cmd-utils,de.tblsoft.solr.pipeline.filter.ShingleFilter,4,0,4,0,0,0.0,0.0,39,0,39,0,0,0,0.0,0.0,15,0,0.0
solr-cmd-utils,de.tblsoft.solr.pipeline.filter.Multivalue2DocumentFilter,2,0,2,0,0,0.0,0.0,11,0,11,0,0,0,0.0,0.0,6,0,0.0
solr-cmd-utils,de.tblsoft.solr.pipeline.filter.BeanShellFilter,3,0,3,0,0,0.0,0.0,23,0,23,0,0,0,0.0,0.0,7,0,0.0
solr-cmd-utils,de.tblsoft.solr.pipeline.filter.HtmlTextExtractorFilter,2,2,0,2,0,100.0,0.0,14,14,0,14,0,0,100.0,0.0,6,5,83.33
solr-cmd-utils,de.tblsoft.solr.pipeline.filter.JsonWriter,6,0,6,0,0,0.0,0.0,89,0,89,0,0,0,0.0,0.0,33,0,0.0
solr-cmd-utils,de.tblsoft.solr.pipeline.filter.ElasticdumpFileWriter,10,0,10,0,0,0.0,0.0,120,0,120,0,0,0,0.0,0.0,41,0,0.0
solr-cmd-utils,de.tblsoft.solr.pipeline.filter.AggregationCountFilter,3,3,0,3,0,100.0,0.0,29,28,1,28,0,0,96.55,0.0,9,9,100.0
solr-cmd-utils,de.tblsoft.solr.pipeline.filter.ConradJsoupFilter,3,0,3,0,0,0.0,0.0,32,0,32,0,0,0,0.0,0.0,13,0,0.0
solr-cmd-utils,de.tblsoft.solr.pipeline.filter.RemoveFieldFilter,2,0,2,0,0,0.0,0.0,6,0,6,0,0,0,0.0,0.0,4,0,0.0
solr-cmd-utils,de.tblsoft.solr.pipeline.filter.OpenNlpPosTagFilter,6,0,6,0,0,0.0,0.0,40,0,40,0,0,0,0.0,0.0,12,0,0.0
solr-cmd-utils,de.tblsoft.solr.pipeline.filter.SynonymNormalizationFilter,2,0,2,0,0,0.0,0.0,55,0,55,0,0,0,0.0,0.0,18,0,0.0
solr-cmd-utils,de.tblsoft.solr.pipeline.filter.ProcessingTimeFilter,2,0,2,0,0,0.0,0.0,5,0,5,0,0,0,0.0,0.0,3,0,0.0
solr-cmd-utils,de.tblsoft.solr.pipeline.filter.FuzzyPermutationFilter,4,4,0,4,0,100.0,0.0,30,30,0,30,0,0,100.0,0.0,13,10,76.92
solr-cmd-utils,de.tblsoft.solr.pipeline.filter.TopicMergeFilter,4,0,4,0,0,0.0,0.0,40,0,40,0,0,0,0.0,0.0,13,0,0.0
solr-cmd-utils,de.tblsoft.solr.pipeline.filter.BlacklistFieldFilter,2,0,2,0,0,0.0,0.0,15,0,15,0,0,0,0.0,0.0,7,0,0.0
solr-cmd-utils,de.tblsoft.solr.pipeline.filter.SleepFilter,3,0,3,0,0,0.0,0.0,11,0,11,0,0,0,0.0,0.0,5,0,0.0
solr-cmd-utils,de.tblsoft.solr.pipeline.filter.RandomStaticValueFilter,2,0,2,0,0,0.0,0.0,9,0,9,0,0,0,0.0,0.0,5,0,0.0
solr-cmd-utils,de.tblsoft.solr.pipeline.filter.StatisticFilter$FieldStatistic,7,0,7,0,0,0.0,0.0,43,0,43,0,0,0,0.0,0.0,21,0,0.0
solr-cmd-utils,de.tblsoft.solr.pipeline.filter.DictionaryNormalizationFilter,4,0,4,0,0,0.0,0.0,36,0,36,0,0,0,0.0,0.0,14,0,0.0
solr-cmd-utils,de.tblsoft.solr.pipeline.filter.StopwordFilter,2,0,2,0,0,0.0,0.0,29,0,29,0,0,0,0.0,0.0,12,0,0.0
solr-cmd-utils,de.tblsoft.solr.pipeline.filter.TopicAggregationFilter$AggregationId,1,0,1,0,0,0.0,0.0,12,0,12,0,0,0,0.0,0.0,3,0,0.0
solr-cmd-utils,de.tblsoft.solr.pipeline.filter.OffsetPermutationFilter,3,0,3,0,0,0.0,0.0,17,0,17,0,0,0,0.0,0.0,10,0,0.0
solr-cmd-utils,de.tblsoft.solr.pipeline.filter.CheckDuplicateFilter,4,0,4,0,0,0.0,0.0,27,0,27,0,0,0,0.0,0.0,12,0,0.0
solr-cmd-utils,de.tblsoft.solr.pipeline.filter.AbstractStatusFilter,6,0,6,0,0,0.0,0.0,53,0,53,0,0,0,0.0,0.0,32,0,0.0
solr-cmd-utils,de.tblsoft.solr.pipeline.filter.ForkDocumentFilter,5,0,5,0,0,0.0,0.0,40,0,40,0,0,0,0.0,0.0,19,0,0.0
solr-cmd-utils,de.tblsoft.solr.pipeline.filter.LowercaseFilter,2,0,2,0,0,0.0,0.0,7,0,7,0,0,0,0.0,0.0,3,0,0.0
solr-cmd-utils,de.tblsoft.solr.pipeline.filter.TopicAggregationFilter,5,0,5,0,0,0.0,0.0,46,0,46,0,0,0,0.0,0.0,15,0,0.0
solr-cmd-utils,de.tblsoft.solr.pipeline.filter.SolrFieldCounter,2,2,0,2,0,100.0,0.0,8,8,0,8,0,0,100.0,0.0,3,3,100.0
solr-cmd-utils,de.tblsoft.solr.pipeline.filter.N3Writer,3,0,3,0,0,0.0,0.0,25,0,25,0,0,0,0.0,0.0,5,0,0.0
solr-cmd-utils,de.tblsoft.solr.pipeline.filter.KafkaWriter,4,0,4,0,0,0.0,0.0,21,0,21,0,0,0,0.0,0.0,6,0,0.0
solr-cmd-utils,de.tblsoft.solr.pipeline.filter.FileMathFilter$AggregationId,1,0,1,0,0,0.0,0.0,12,0,12,0,0,0,0.0,0.0,3,0,0.0
solr-cmd-utils,de.tblsoft.solr.pipeline.filter.KeyValueSplitterFilter,3,3,0,3,0,100.0,0.0,31,29,2,29,0,0,93.55,0.0,11,8,72.73
solr-cmd-utils,de.tblsoft.solr.pipeline.filter.CharCounterFilter,2,0,2,0,0,0.0,0.0,10,0,10,0,0,0,0.0,0.0,5,0,0.0
solr-cmd-utils,de.tblsoft.solr.pipeline.filter.BlacklistTopicFilter,2,0,2,0,0,0.0,0.0,38,0,38,0,0,0,0.0,0.0,10,0,0.0
solr-cmd-utils,de.tblsoft.solr.pipeline.filter.WhitelistTopicTermsFilter,3,0,3,0,0,0.0,0.0,66,0,66,0,0,0,0.0,0.0,17,0,0.0
solr-cmd-utils,de.tblsoft.solr.pipeline.filter.ExternalFilterWorker,1,0,1,0,0,0.0,0.0,19,0,19,0,0,0,0.0,0.0,5,0,0.0
solr-cmd-utils,de.tblsoft.solr.pipeline.filter.TestingFilter,5,5,0,3,2,100.0,40.0,8,8,0,8,0,0,100.0,0.0,7,2,28.57
solr-cmd-utils,de.tblsoft.solr.pipeline.filter.ElasticWriter,13,2,11,2,0,15.38,0.0,263,19,244,19,0,0,7.22,0.0,84,7,8.33
solr-cmd-utils,de.tblsoft.solr.pipeline.filter.SystemOutWriter,3,0,3,0,0,0.0,0.0,18,0,18,0,0,0,0.0,0.0,7,0,0.0
solr-cmd-utils,de.tblsoft.solr.pipeline.filter.SpyFilter,2,0,2,0,0,0.0,0.0,7,0,7,0,0,0,0.0,0.0,2,0,0.0
solr-cmd-utils,de.tblsoft.solr.pipeline.filter.XmlSitemapWriter,7,0,7,0,0,0.0,0.0,70,0,70,0,0,0,0.0,0.0,33,0,0.0
solr-cmd-utils,de.tblsoft.solr.pipeline.filter.ValueMappingFilter,2,0,2,0,0,0.0,0.0,19,0,19,0,0,0,0.0,0.0,8,0,0.0
solr-cmd-utils,de.tblsoft.solr.pipeline.filter.HtmlJsoupFilter,13,0,13,0,0,0.0,0.0,113,0,113,0,0,0,0.0,0.0,52,0,0.0
solr-cmd-utils,de.tblsoft.solr.pipeline.filter.CSVWriter,4,4,0,4,0,100.0,0.0,54,49,5,49,0,0,90.74,0.0,14,9,64.29
solr-cmd-utils,de.tblsoft.solr.pipeline.filter.RegexSplitFilter,3,3,0,3,0,100.0,0.0,30,25,5,25,0,0,83.33,0.0,18,9,50.0
solr-cmd-utils,de.tblsoft.solr.pipeline.filter.RestWorker,3,0,3,0,0,0.0,0.0,48,0,48,0,0,0,0.0,0.0,21,0,0.0
solr-cmd-utils,de.tblsoft.solr.pipeline.filter.StatisticFilter,4,0,4,0,0,0.0,0.0,36,0,36,0,0,0,0.0,0.0,11,0,0.0
solr-cmd-utils,de.tblsoft.solr.pipeline.filter.BasicAuthConcurrentUpdateSolrClient,2,0,2,0,0,0.0,0.0,6,0,6,0,0,0,0.0,0.0,2,0,0.0
solr-cmd-utils,de.tblsoft.solr.pipeline.filter.SimpleMapping,7,4,3,3,1,57.14,14.29,175,108,67,108,0,0,61.71,0.0,60,41,68.33
solr-cmd-utils,de.tblsoft.solr.pipeline.filter.GrokFilter,3,0,3,0,0,0.0,0.0,13,0,13,0,0,0,0.0,0.0,5,0,0.0
solr-cmd-utils,de.tblsoft.solr.pipeline.filter.SolrNumFoundFilter,2,0,2,0,0,0.0,0.0,17,0,17,0,0,0,0.0,0.0,6,0,0.0
solr-cmd-utils,de.tblsoft.solr.pipeline.filter.LastFilter,0,0,0,0,0,0.0,0.0,0,0,0,0,0,0,0.0,0.0,0,0,0
solr-cmd-utils,de.tblsoft.solr.pipeline.filter.SolrFeeder,4,0,4,0,0,0.0,0.0,47,0,47,0,0,0,0.0,0.0,15,0,0.0
solr-cmd-utils,de.tblsoft.solr.pipeline.filter.EmptyArrayValuesFilter,2,0,2,0,0,0.0,0.0,13,0,13,0,0,0,0.0,0.0,8,0,0.0
solr-cmd-utils,de.tblsoft.solr.pipeline.filter.HtmlFilter,3,0,3,0,0,0.0,0.0,61,0,61,0,0,0,0.0,0.0,24,0,0.0
solr-cmd-utils,de.tblsoft.solr.pipeline.filter.HttpFilter,4,0,4,0,0,0.0,0.0,45,0,45,0,0,0,0.0,0.0,14,0,0.0
solr-cmd-utils,de.tblsoft.solr.pipeline.filter.RichJavaScriptFilter,3,0,3,0,0,0.0,0.0,27,0,27,0,0,0,0.0,0.0,8,0,0.0
solr-cmd-utils,de.tblsoft.solr.pipeline.filter.LookupFilter,3,3,0,3,0,100.0,0.0,15,15,0,15,0,0,100.0,0.0,3,1,33.33
solr-cmd-utils,de.tblsoft.solr.pipeline.filter.DateFilter,2,2,0,2,0,100.0,0.0,18,18,0,17,1,1,100.0,5.56,7,4,57.14
solr-cmd-utils,de.tblsoft.solr.pipeline.filter.TokenizerFilter,2,2,0,2,0,100.0,0.0,11,11,0,11,0,0,100.0,0.0,4,4,100.0
solr-cmd-utils,de.tblsoft.solr.pipeline.filter.ExcludeByValueFilter,2,0,2,0,0,0.0,0.0,7,0,7,0,0,0,0.0,0.0,4,0,0.0
solr-cmd-utils,de.tblsoft.solr.pipeline.filter.RegexReplaceFilter,2,0,2,0,0,0.0,0.0,17,0,17,0,0,0,0.0,0.0,7,0,0.0
solr-cmd-utils,de.tblsoft.solr.pipeline.filter.RemoveHtmlFilter,2,0,2,0,0,0.0,0.0,7,0,7,0,0,0,0.0,0.0,3,0,0.0
solr-cmd-utils,de.tblsoft.solr.pipeline.filter.OpenNlpPosTagWriteTrainingFilter,3,0,3,0,0,0.0,0.0,24,0,24,0,0,0,0.0,0.0,6,0,0.0
solr-cmd-utils,de.tblsoft.solr.pipeline.filter.AbstractSubFieldFilter,3,2,1,2,0,66.67,0.0,37,9,28,9,0,0,24.32,0.0,17,4,23.53
solr-cmd-utils,de.tblsoft.solr.pipeline.filter.FileMathFilter,4,0,4,0,0,0.0,0.0,69,0,69,0,0,0,0.0,0.0,25,0,0.0
solr-cmd-utils,de.tblsoft.solr.pipeline.filter.ExpectedDocumentCountFilter,3,0,3,0,0,0.0,0.0,10,0,10,0,0,0,0.0,0.0,6,0,0.0
solr-cmd-utils,de.tblsoft.solr.pipeline.filter.NounExtractorFilter,7,0,7,0,0,0.0,0.0,48,0,48,0,0,0,0.0,0.0,27,0,0.0
solr-cmd-utils,de.tblsoft.solr.pipeline.filter.CompoundWordFilter,5,0,5,0,0,0.0,0.0,72,0,72,0,0,0,0.0,0.0,33,0,0.0
solr-cmd-utils,de.tblsoft.solr.pipeline.filter.EmptyFieldDocumentFilter,2,0,2,0,0,0.0,0.0,7,0,7,0,0,0,0.0,0.0,6,0,0.0
solr-cmd-utils,de.tblsoft.solr.pipeline.filter.RegexExtractFilter,3,0,3,0,0,0.0,0.0,22,0,22,0,0,0,0.0,0.0,9,0,0.0
solr-cmd-utils,de.tblsoft.solr.pipeline.filter.DocumentJoinerFilter,2,2,0,2,0,100.0,0.0,19,17,2,17,0,0,89.47,0.0,7,7,100.0
solr-cmd-utils,de.tblsoft.solr.pipeline.filter.EncodingCorrectionFilter,1,0,1,0,0,0.0,0.0,3,0,3,0,0,0,0.0,0.0,2,0,0.0
solr-cmd-utils,de.tblsoft.solr.pipeline.filter.RestWorker$RestRequest,0,0,0,0,0,0.0,0.0,4,4,0,4,0,0,100.0,0.0,0,0,0
solr-cmd-utils,de.tblsoft.solr.pipeline.filter.HttpWorker,1,0,1,0,0,0.0,0.0,36,0,36,0,0,0,0.0,0.0,17,0,0.0
solr-cmd-utils,de.tblsoft.solr.pipeline.filter.RestFilter,8,5,3,5,0,62.5,0.0,83,47,36,47,0,0,56.63,0.0,27,8,29.63
solr-cmd-utils,de.tblsoft.solr.pipeline.filter.SimpleGenderFilter,4,2,2,2,0,50.0,0.0,47,32,15,32,0,0,68.09,0.0,18,9,50.0
solr-cmd-utils,de.tblsoft.solr.pipeline.filter.GrepFilter,2,2,0,2,0,100.0,0.0,16,15,1,15,0,0,93.75,0.0,8,5,62.5
solr-cmd-utils,de.tblsoft.solr.pipeline.filter.LibSvmWriter,10,0,10,0,0,0.0,0.0,87,0,87,0,0,0,0.0,0.0,28,0,0.0
solr-cmd-utils,de.tblsoft.solr.pipeline.filter.ValidationFilter,4,4,0,3,1,100.0,25.0,18,13,5,13,0,0,72.22,0.0,11,7,63.64
solr-cmd-utils,de.tblsoft.solr.pipeline.filter.UrlSplitter,2,2,0,2,0,100.0,0.0,36,33,3,33,0,0,91.67,0.0,17,9,52.94
solr-cmd-utils,de.tblsoft.solr.pipeline.filter.TokenPermutationFilter,5,0,5,0,0,0.0,0.0,40,0,40,0,0,0,0.0,0.0,17,0,0.0
solr-cmd-utils,de.tblsoft.solr.pipeline.filter.FieldJoiner,2,2,0,2,0,100.0,0.0,12,12,0,12,0,0,100.0,0.0,5,3,60.0
solr-cmd-utils,de.tblsoft.solr.pipeline.filter.TokenCounterFilter,2,0,2,0,0,0.0,0.0,11,0,11,0,0,0,0.0,0.0,5,0,0.0
solr-cmd-utils,de.tblsoft.solr.pipeline.filter.IgnoreDocumentFilter,2,2,0,2,0,100.0,0.0,16,16,0,16,0,0,100.0,0.0,11,8,72.73
solr-cmd-utils,de.tblsoft.solr.pipeline.filter.nlp.SearchQueryAnalyzerFilter,5,0,5,0,0,0.0,0.0,47,0,47,0,0,0,0.0,0.0,30,0,0.0
solr-cmd-utils,de.tblsoft.solr.cache.FileCache,4,0,4,0,0,0.0,0.0,35,0,35,0,0,0,0.0,0.0,13,0,0.0
solr-cmd-utils,de.tblsoft.solr.util.DocumentUtils,4,1,3,1,0,25.0,0.0,13,3,10,3,0,0,23.08,0.0,4,1,25.0
solr-cmd-utils,de.tblsoft.solr.util.DateUtils,6,3,3,2,1,50.0,16.67,16,8,8,8,0,0,50.0,0.0,6,2,33.33
solr-cmd-utils,de.tblsoft.solr.util.PairBuilder,1,0,1,0,0,0.0,0.0,5,0,5,0,0,0,0.0,0.0,2,0,0.0
solr-cmd-utils,de.tblsoft.solr.util.InstantUtils,1,1,0,1,0,100.0,0.0,4,3,1,3,0,0,75.0,0.0,3,2,66.67
solr-cmd-utils,de.tblsoft.solr.util.XPathUtils,1,0,1,0,0,0.0,0.0,7,0,7,0,0,0,0.0,0.0,1,0,0.0
solr-cmd-utils,de.tblsoft.solr.util.OutputStreamStringBuilder,1,0,1,0,0,0.0,0.0,5,0,5,0,0,0,0.0,0.0,2,0,0.0
solr-cmd-utils,de.tblsoft.solr.util.MapUtils,1,0,1,0,0,0.0,0.0,1,0,1,0,0,0,0.0,0.0,2,0,0.0
solr-cmd-utils,de.tblsoft.solr.util.DocumentMapper,1,0,1,0,0,0.0,0.0,10,0,10,0,0,0,0.0,0.0,4,0,0.0
solr-cmd-utils,de.tblsoft.solr.util.DatatypeUtils,6,3,3,3,0,50.0,0.0,53,33,20,33,0,0,62.26,0.0,32,18,56.25
solr-cmd-utils,de.tblsoft.solr.util.IOUtils,12,5,7,5,0,41.67,0.0,79,28,51,26,2,2,35.44,2.53,43,20,46.51
solr-cmd-utils,de.tblsoft.solr.util.JsonUtil,1,0,1,0,0,0.0,0.0,2,0,2,0,0,0,0.0,0.0,1,0,0.0
solr-cmd-utils,de.tblsoft.solr.util.XMLCharacters,0,0,0,0,0,0.0,0.0,0,0,0,0,0,0,0.0,0.0,0,0,0
solr-cmd-utils,de.tblsoft.solr.elastic.ElasticBulkRequest,0,0,0,0,0,0.0,0.0,0,0,0,0,0,0,0.0,0.0,0,0,0
solr-cmd-utils,de.tblsoft.solr.elastic.AliasManager,6,2,4,2,0,33.33,0.0,32,8,24,8,0,0,25.0,0.0,8,3,37.5
solr-cmd-utils,de.tblsoft.solr.elastic.ElasticScrollQuery,3,0,3,0,0,0.0,0.0,55,0,55,0,0,0,0.0,0.0,15,0,0.0
solr-cmd-utils,de.tblsoft.solr.bean.SolrConfiguration,1,0,1,0,0,0.0,0.0,1,0,1,0,0,0,0.0,0.0,1,0,0.0
solr-cmd-utils,de.tblsoft.solr.bean.Core,3,0,3,0,0,0.0,0.0,6,0,6,0,0,0,0.0,0.0,5,0,0.0
solr-cmd-utils,de.tblsoft.solr.bean.Cores,4,0,4,0,0,0.0,0.0,18,0,18,0,0,0,0.0,0.0,7,0,0.0
solr-cmd-utils,de.tblsoft.solr.logic.LinguisticHelper,1,0,1,0,0,0.0,0.0,1,0,1,0,0,0,0.0,0.0,2,0,0.0
solr-cmd-utils,de.tblsoft.solr.logic.SpecialCharacterExtractor,3,0,3,0,0,0.0,0.0,30,0,30,0,0,0,0.0,0.0,9,0,0.0
solr-cmd-utils,de.tblsoft.solr.logic.UsedFieldCounter,2,0,2,0,0,0.0,0.0,8,0,8,0,0,0,0.0,0.0,2,0,0.0
solr-cmd-utils,de.tblsoft.solr.logic.iban.RandomIbanGenerator,4,3,1,3,0,75.0,0.0,16,11,5,10,1,1,68.75,6.25,9,7,77.78
solr-cmd-utils,de.tblsoft.solr.sitemap.bean.UrlSet,0,0,0,0,0,0.0,0.0,0,0,0,0,0,0,0.0,0.0,0,0,0
solr-cmd-utils,de.tblsoft.solr.sitemap.bean.Sitemapindex,0,0,0,0,0,0.0,0.0,0,0,0,0,0,0,0.0,0.0,0,0,0
solr-cmd-utils,de.tblsoft.solr.sitemap.bean.Url,0,0,0,0,0,0.0,0.0,0,0,0,0,0,0,0.0,0.0,0,0,0
solr-cmd-utils,de.tblsoft.solr.sitemap.bean.Sitemap,0,0,0,0,0,0.0,0.0,0,0,0,0,0,0,0.0,0.0,0,0,0
solr-cmd-utils,de.tblsoft.solr.parser.SolrXmlParser,1,0,1,0,0,0.0,0.0,55,0,55,0,0,0,0.0,0.0,22,0,0.0
solr-cmd-utils,de.tblsoft.solr.xml.Formatter,1,0,1,0,0,0.0,0.0,9,0,9,0,0,0,0.0,0.0,3,0,0.0
solr-cmd-utils,de.tblsoft.solr.schema.SolrSchemaManager,5,0,5,0,0,0.0,0.0,32,0,32,0,0,0,0.0,0.0,5,0,0.0
solr-cmd-utils,de.tblsoft.solr.crawl.Breadcrumb,1,0,1,0,0,0.0,0.0,4,0,4,0,0,0,0.0,0.0,1,0,0.0
solr-cmd-utils,de.tblsoft.solr.crawl.BreadcrumbEntry,0,0,0,0,0,0.0,0.0,0,0,0,0,0,0,0.0,0.0,0,0,0
solr-cmd-utils,de.tblsoft.solr.crawl.Custom,1,0,1,0,0,0.0,0.0,4,0,4,0,0,0,0.0,0.0,1,0,0.0
solr-cmd-utils,de.tblsoft.solr.crawl.Webpage,4,0,4,0,0,0.0,0.0,16,0,16,0,0,0,0.0,0.0,7,0,0.0
solr-cmd-utils,de.tblsoft.solr.crawl.Meta,3,0,3,0,0,0.0,0.0,12,0,12,0,0,0,0.0,0.0,3,0,0.0
solr-cmd-utils,de.tblsoft.solr.crawl.JSoupAnalyzer,19,0,19,0,0,0.0,0.0,166,0,166,0,0,0,0.0,0.0,84,0,0.0
solr-cmd-utils,de.tblsoft.solr.crawl.attr.DlDdDtAttributeExtractor,1,0,1,0,0,0.0,0.0,11,0,11,0,0,0,0.0,0.0,3,0,0.0
solr-cmd-utils,de.tblsoft.solr.crawl.attr.TableThTdAttributeExtractor,1,0,1,0,0,0.0,0.0,11,0,11,0,0,0,0.0,0.0,3,0,0.0
solr-cmd-utils,de.tblsoft.solr.crawl.attr.TableTdTdAttributeExtractor,1,0,1,0,0,0.0,0.0,18,0,18,0,0,0,0.0,0.0,7,0,0.0
solr-cmd-utils,de.tblsoft.solr.crawl.attr.Attribute,0,0,0,0,0,0.0,0.0,0,0,0,0,0,0,0.0,0.0,0,0,0
solr-cmd-utils,de.tblsoft.solr.crawl.attr.AttributeExtractor,0,0,0,0,0,0.0,0.0,0,0,0,0,0,0,0.0,0.0,0,0,0
solr-cmd-utils,de.tblsoft.solr.crawl.attr.AttributeExtractorFactory,1,0,1,0,0,0.0,0.0,13,0,13,0,0,0,0.0,0.0,9,0,0.0
solr-cmd-utils,de.tblsoft.solr.crawl.attr.ParagraphAttributeExtractor,1,0,1,0,0,0.0,0.0,11,0,11,0,0,0,0.0,0.0,3,0,0.0
solr-cmd-utils,de.tblsoft.solr.crawl.attr.Attributes,1,0,1,0,0,0.0,0.0,4,0,4,0,0,0,0.0,0.0,1,0,0.0
solr-cmd-utils,de.tblsoft.solr.http.SolrFile,5,0,5,0,0,0.0,0.0,30,0,30,0,0,0,0.0,0.0,12,0,0.0
solr-cmd-utils,de.tblsoft.solr.http.GlobalHttpConfiguration,2,1,1,0,1,50.0,50.0,11,3,8,3,0,0,27.27,0.0,3,0,0.0
solr-cmd-utils,de.tblsoft.solr.http.HTTPHelper,15,4,11,2,2,26.67,13.33,151,20,131,20,0,0,13.25,0.0,63,7,11.11
solr-cmd-utils,de.tblsoft.solr.http.Solr,6,0,6,0,0,0.0,0.0,60,0,60,0,0,0,0.0,0.0,17,0,0.0
solr-cmd-utils,de.tblsoft.solr.http.UrlUtil,12,8,4,6,2,66.67,16.67,49,24,25,24,0,0,48.98,0.0,15,7,46.67
solr-cmd-utils,de.tblsoft.solr.http.ElasticHelper,17,11,6,11,0,64.71,0.0,126,68,58,56,12,11,53.97,9.52,50,32,64.0
solr-cmd-utils,de.tblsoft.solr.compare.SearchResultDiff,7,7,0,5,2,100.0,28.57,40,28,12,28,0,0,70.0,0.0,27,19,70.37
solr-cmd-utils,de.tblsoft.solr.compare.Result,0,0,0,0,0,0.0,0.0,2,2,0,2,0,0,100.0,0.0,0,0,0
solr-cmd-utils,de.tblsoft.solr.compare.SolrCompareFilter,3,0,3,0,0,0.0,0.0,47,0,47,0,0,0,0.0,0.0,18,0,0.0
solr-cmd-utils,de.tblsoft.solr.compare.SearchResult,1,0,1,0,0,0.0,0.0,1,0,1,0,0,0,0.0,0.0,2,0,0.0
solr-cmd-utils,de.tblsoft.solr.log.parser.SolrRequestCounter,6,0,6,0,0,0.0,0.0,23,0,23,0,0,0,0.0,0.0,8,0,0.0
solr-cmd-utils,de.tblsoft.solr.log.parser.LogParser,2,0,2,0,0,0.0,0.0,24,0,24,0,0,0,0.0,0.0,8,0,0.0
solr-cmd-utils,de.tblsoft.solr.log.parser.RequestCounter,5,0,5,0,0,0.0,0.0,22,0,22,0,0,0,0.0,0.0,8,0,0.0
solr-cmd-utils,de.tblsoft.solr.log.parser.SolrQueryLogParser,3,0,3,0,0,0.0,0.0,46,0,46,0,0,0,0.0,0.0,20,0,0.0
solr-cmd-utils,de.tblsoft.solr.log.parser.SolrLogRow,5,0,5,0,0,0.0,0.0,42,0,42,0,0,0,0.0,0.0,23,0,0.0
solr-cmd-utils,com.quasiris.qsc.reader.FeedingQueueReader,2,0,2,0,0,0.0,0.0,32,0,32,0,0,0,0.0,0.0,10,0,0.0
solr-cmd-utils,com.quasiris.qsc.reader.FeedingQueue,1,0,1,0,0,0.0,0.0,1,0,1,0,0,0,0.0,0.0,1,0,0.0
solr-cmd-utils,com.quasiris.qsc.writer.QscDataPushWriter,5,0,5,0,0,0.0,0.0,37,0,37,0,0,0,0.0,0.0,12,0,0.0
solr-cmd-utils,com.quasiris.qsc.writer.dto.Header,0,0,0,0,0,0.0,0.0,0,0,0,0,0,0,0.0,0.0,0,0,0
solr-cmd-utils,com.quasiris.qsc.writer.dto.QscFeedingDocument,0,0,0,0,0,0.0,0.0,0,0,0,0,0,0,0.0,0.0,0,0,0
SequencePattern,sequencepattern.condition.NumberOfInstancesOf,5,0,5,0,0,0.0,0.0,15,0,15,0,0,0,0.0,0.0,15,0,0.0
SequencePattern,sequencepattern.condition.StartsWithCondition,2,0,2,0,0,0.0,0.0,3,0,3,0,0,0,0.0,0.0,4,0,0.0
SequencePattern,sequencepattern.condition.EqualCondition,2,1,1,1,0,50.0,0.0,4,3,1,3,0,0,75.0,0.0,3,2,66.67
SequencePattern,sequencepattern.condition.NumberOfElements,4,0,4,0,0,0.0,0.0,7,0,7,0,0,0,0.0,0.0,10,0,0.0
SequencePattern,sequencepattern.condition.GreaterThanCondition,2,1,1,0,1,50.0,50.0,4,3,1,3,0,0,75.0,0.0,3,1,33.33
SequencePattern,sequencepattern.condition.ExactNumber,5,1,4,0,1,20.0,20.0,9,2,7,2,0,0,22.22,0.0,11,0,0.0
SequencePattern,sequencepattern.condition.Condition,0,0,0,0,0,0.0,0.0,0,0,0,0,0,0,0.0,0.0,0,0,0
SequencePattern,sequencepattern.condition.NotCondition,2,1,1,1,0,50.0,0.0,3,2,1,2,0,0,66.67,0.0,3,2,66.67
SequencePattern,sequencepattern.condition.Countable,0,0,0,0,0,0.0,0.0,0,0,0,0,0,0,0.0,0.0,0,0,0
SequencePattern,sequencepattern.condition.NumberOf,5,3,2,2,1,60.0,20.0,15,12,3,12,0,0,80.0,0.0,15,8,53.33
SequencePattern,sequencepattern.condition.Comparable,0,0,0,0,0,0.0,0.0,0,0,0,0,0,0,0.0,0.0,0,0,0
SequencePattern,sequencepattern.condition.OrCondition,2,1,1,0,1,50.0,50.0,18,5,13,5,0,0,27.78,0.0,9,1,11.11
SequencePattern,sequencepattern.condition.AndCondition,2,1,1,1,0,50.0,0.0,15,6,9,6,0,0,40.0,0.0,9,3,33.33
SequencePattern,sequencepattern.condition.StartsWithTypeCondition,2,0,2,0,0,0.0,0.0,3,0,3,0,0,0,0.0,0.0,4,0,0.0
SequencePattern,sequencepattern.condition.SmallerThanCondition,2,0,2,0,0,0.0,0.0,4,0,4,0,0,0,0.0,0.0,3,0,0.0
SequencePattern,sequencepattern.condition.ConditionBuilder,1,1,0,1,0,100.0,0.0,5,3,2,3,0,0,60.0,0.0,3,3,100.0
SequencePattern,sequencepattern.condition.SumOf,5,0,5,0,0,0.0,0.0,14,0,14,0,0,0,0.0,0.0,14,0,0.0
SequencePattern,sequencepattern.pattern.AnyPattern,1,1,0,1,0,100.0,0.0,4,2,2,2,0,0,50.0,0.0,3,2,66.67
SequencePattern,sequencepattern.pattern.AnyClassPattern,2,1,1,1,0,50.0,0.0,20,8,12,8,0,0,40.0,0.0,12,3,25.0
SequencePattern,sequencepattern.pattern.RepeatAtLeastPattern,2,0,2,0,0,0.0,0.0,35,0,35,0,0,0,0.0,0.0,17,0,0.0
SequencePattern,sequencepattern.pattern.PatternReference,5,1,4,1,0,20.0,0.0,12,3,9,3,0,0,25.0,0.0,10,2,20.0
SequencePattern,sequencepattern.pattern.NotEqualToAnyPattern,2,0,2,0,0,0.0,0.0,21,0,21,0,0,0,0.0,0.0,13,0,0.0
SequencePattern,sequencepattern.pattern.SelfPattern,1,1,0,1,0,100.0,0.0,2,2,0,2,0,0,100.0,0.0,1,1,100.0
SequencePattern,sequencepattern.pattern.PatternBuilder,10,2,8,2,0,20.0,0.0,16,6,10,6,0,0,37.5,0.0,13,5,38.46
SequencePattern,sequencepattern.pattern.IfPattern,2,1,1,1,0,50.0,0.0,10,9,1,9,0,0,90.0,0.0,3,2,66.67
SequencePattern,sequencepattern.pattern.EqualToAnyPattern,2,1,1,1,0,50.0,0.0,20,8,12,8,0,0,40.0,0.0,12,3,25.0
SequencePattern,sequencepattern.pattern.ElementSequence,30,10,20,9,1,33.33,3.33,55,22,33,22,0,0,40.0,0.0,46,11,23.91
SequencePattern,sequencepattern.pattern.RepeatWhilePattern,2,1,1,1,0,50.0,0.0,32,21,11,21,0,0,65.62,0.0,17,10,58.82
SequencePattern,sequencepattern.pattern.RepeatIndefinitelyPattern,2,1,1,1,0,50.0,0.0,23,18,5,18,0,0,78.26,0.0,10,7,70.0
SequencePattern,sequencepattern.pattern.OrPattern,2,1,1,1,0,50.0,0.0,14,6,8,6,0,0,42.86,0.0,7,1,14.29
SequencePattern,sequencepattern.pattern.NotAnyClassPattern,2,0,2,0,0,0.0,0.0,21,0,21,0,0,0,0.0,0.0,13,0,0.0
SequencePattern,sequencepattern.pattern.Pattern,2,0,2,0,0,0.0,0.0,8,0,8,0,0,0,0.0,0.0,4,0,0.0
SequencePattern,sequencepattern.pattern.RepeatExactlyPattern,2,1,1,1,0,50.0,0.0,30,19,11,19,0,0,63.33,0.0,15,11,73.33
SequencePattern,sequencepattern.pattern.AndPattern,2,1,1,1,0,50.0,0.0,44,34,10,34,0,0,77.27,0.0,24,13,54.17
SequencePattern,sequencepattern.pattern.OptionalPattern,2,1,1,1,0,50.0,0.0,7,6,1,6,0,0,85.71,0.0,2,1,50.0
commons-math-3.6.1,org.apache.commons.math3.FieldElement,0,0,0,0,0,0.0,0.0,0,0,0,0,0,0,0.0,0.0,0,0,0
commons-math-3.6.1,org.apache.commons.math3.Field,0,0,0,0,0,0.0,0.0,0,0,0,0,0,0,0.0,0.0,0,0,0
commons-math-3.6.1,org.apache.commons.math3.RealFieldElement,0,0,0,0,0,0.0,0.0,0,0,0,0,0,0,0.0,0.0,0,0,0
commons-math-3.6.1,org.apache.commons.math3.primes.PollardRho,3,0,3,0,0,0.0,0.0,58,0,58,0,0,0,0.0,0.0,41,0,0.0
commons-math-3.6.1,org.apache.commons.math3.primes.SmallPrimes,4,4,0,4,0,100.0,0.0,63,57,6,57,0,0,90.48,0.0,43,27,62.79
commons-math-3.6.1,org.apache.commons.math3.primes.Primes,3,3,0,3,0,100.0,0.0,41,41,0,41,0,0,100.0,0.0,32,31,96.88
commons-math-3.6.1,org.apache.commons.math3.fitting.PolynomialCurveFitter,4,3,1,3,0,75.0,0.0,14,11,3,11,0,0,78.57,0.0,7,6,85.71
commons-math-3.6.1,org.apache.commons.math3.fitting.CurveFitter$TheoreticalValuesFunction,4,4,0,4,0,100.0,0.0,11,11,0,11,0,0,100.0,0.0,2,2,100.0
commons-math-3.6.1,org.apache.commons.math3.fitting.HarmonicCurveFitter,4,3,1,3,0,75.0,0.0,11,10,1,10,0,0,90.91,0.0,6,5,83.33
commons-math-3.6.1,org.apache.commons.math3.fitting.AbstractCurveFitter,2,2,0,2,0,100.0,0.0,2,2,0,2,0,0,100.0,0.0,2,2,100.0
commons-math-3.6.1,org.apache.commons.math3.fitting.GaussianFitter$ParameterGuesser,8,8,0,7,1,100.0,12.5,74,43,31,43,0,0,58.11,0.0,55,42,76.36
commons-math-3.6.1,org.apache.commons.math3.fitting.HarmonicFitter$ParameterGuesser,4,4,0,4,0,100.0,0.0,85,83,2,83,0,0,97.65,0.0,90,63,70.0
commons-math-3.6.1,org.apache.commons.math3.fitting.GaussianFitter,4,4,0,4,0,100.0,0.0,10,10,0,10,0,0,100.0,0.0,2,2,100.0
commons-math-3.6.1,org.apache.commons.math3.fitting.WeightedObservedPoints,5,5,0,5,0,100.0,0.0,5,5,0,5,0,0,100.0,0.0,3,3,100.0
commons-math-3.6.1,org.apache.commons.math3.fitting.AbstractCurveFitter$TheoreticalValuesFunction,4,4,0,4,0,100.0,0.0,15,15,0,15,0,0,100.0,0.0,2,2,100.0
commons-math-3.6.1,org.apache.commons.math3.fitting.WeightedObservedPoint,3,3,0,2,1,100.0,33.33,6,6,0,6,0,0,100.0,0.0,3,3,100.0
commons-math-3.6.1,org.apache.commons.math3.fitting.HarmonicFitter,2,2,0,2,0,100.0,0.0,2,2,0,2,0,0,100.0,0.0,2,2,100.0
commons-math-3.6.1,org.apache.commons.math3.fitting.GaussianCurveFitter$ParameterGuesser,8,8,0,7,1,100.0,12.5,74,43,31,43,0,0,58.11,0.0,55,42,76.36
commons-math-3.6.1,org.apache.commons.math3.fitting.PolynomialFitter,2,1,1,1,0,50.0,0.0,2,1,1,1,0,0,50.0,0.0,2,1,50.0
commons-math-3.6.1,org.apache.commons.math3.fitting.HarmonicCurveFitter$ParameterGuesser,4,4,0,4,0,100.0,0.0,85,83,2,83,0,0,97.65,0.0,90,63,70.0
commons-math-3.6.1,org.apache.commons.math3.fitting.SimpleCurveFitter,4,2,2,2,0,50.0,0.0,12,10,2,10,0,0,83.33,0.0,5,3,60.0
commons-math-3.6.1,org.apache.commons.math3.fitting.GaussianCurveFitter,6,6,0,6,0,100.0,0.0,19,19,0,19,0,0,100.0,0.0,6,6,100.0
commons-math-3.6.1,org.apache.commons.math3.fitting.CurveFitter,7,6,1,6,0,85.71,0.0,16,15,1,15,0,0,93.75,0.0,6,6,100.0
commons-math-3.6.1,org.apache.commons.math3.fitting.leastsquares.LeastSquaresProblem,0,0,0,0,0,0.0,0.0,0,0,0,0,0,0,0.0,0.0,0,0,0
commons-math-3.6.1,org.apache.commons.math3.fitting.leastsquares.LeastSquaresBuilder,14,13,1,13,0,92.86,0.0,23,21,2,21,0,0,91.3,0.0,14,13,92.86
commons-math-3.6.1,org.apache.commons.math3.fitting.leastsquares.LevenbergMarquardtOptimizer$InternalData,0,0,0,0,0,0.0,0.0,6,6,0,6,0,0,100.0,0.0,0,0,0
commons-math-3.6.1,org.apache.commons.math3.fitting.leastsquares.LeastSquaresFactory$LocalValueAndJacobianFunction,3,3,0,3,0,100.0,0.0,5,5,0,5,0,0,100.0,0.0,3,3,100.0
commons-math-3.6.1,org.apache.commons.math3.fitting.leastsquares.MultivariateJacobianFunction,0,0,0,0,0,0.0,0.0,0,0,0,0,0,0,0.0,0.0,0,0,0
commons-math-3.6.1,org.apache.commons.math3.fitting.leastsquares.ValueAndJacobianFunction,0,0,0,0,0,0.0,0.0,0,0,0,0,0,0,0.0,0.0,0,0,0
commons-math-3.6.1,org.apache.commons.math3.fitting.leastsquares.LeastSquaresFactory,13,7,6,7,0,53.85,0.0,23,16,7,16,0,0,69.57,0.0,17,11,64.71
commons-math-3.6.1,org.apache.commons.math3.fitting.leastsquares.LeastSquaresFactory$LocalLeastSquaresProblem$UnweightedEvaluation,3,3,0,3,0,100.0,0.0,6,6,0,6,0,0,100.0,0.0,3,3,100.0
commons-math-3.6.1,org.apache.commons.math3.fitting.leastsquares.GaussNewtonOptimizer,5,2,3,2,0,40.0,0.0,36,31,5,31,0,0,86.11,0.0,29,23,79.31
commons-math-3.6.1,org.apache.commons.math3.fitting.leastsquares.AbstractEvaluation,4,4,0,4,0,100.0,0.0,8,8,0,8,0,0,100.0,0.0,9,9,100.0
commons-math-3.6.1,org.apache.commons.math3.fitting.leastsquares.LeastSquaresOptimizer$Optimum,0,0,0,0,0,0.0,0.0,0,0,0,0,0,0,0.0,0.0,0,0,0
commons-math-3.6.1,org.apache.commons.math3.fitting.leastsquares.LeastSquaresOptimizer,0,0,0,0,0,0.0,0.0,0,0,0,0,0,0,0.0,0.0,0,0,0
commons-math-3.6.1,org.apache.commons.math3.fitting.leastsquares.DenseWeightedEvaluation,3,3,0,3,0,100.0,0.0,5,5,0,5,0,0,100.0,0.0,3,3,100.0
commons-math-3.6.1,org.apache.commons.math3.fitting.leastsquares.LeastSquaresFactory$LocalLeastSquaresProblem$LazyUnweightedEvaluation,3,2,1,2,0,66.67,0.0,6,5,1,5,0,0,83.33,0.0,3,0,0.0
commons-math-3.6.1,org.apache.commons.math3.fitting.leastsquares.LeastSquaresProblem$Evaluation,0,0,0,0,0,0.0,0.0,0,0,0,0,0,0,0.0,0.0,0,0,0
commons-math-3.6.1,org.apache.commons.math3.fitting.leastsquares.LeastSquaresAdapter,7,7,0,7,0,100.0,0.0,8,8,0,8,0,0,100.0,0.0,7,7,100.0
commons-math-3.6.1,org.apache.commons.math3.fitting.leastsquares.GaussNewtonOptimizer$Decomposition,4,4,0,4,0,100.0,0.0,10,10,0,10,0,0,100.0,0.0,0,0,0
commons-math-3.6.1,org.apache.commons.math3.fitting.leastsquares.OptimumImpl,9,7,2,6,1,77.78,11.11,12,10,2,10,0,0,83.33,0.0,9,7,77.78
commons-math-3.6.1,org.apache.commons.math3.fitting.leastsquares.EvaluationRmsChecker,1,1,0,1,0,100.0,0.0,3,3,0,2,1,0,100.0,33.33,3,3,100.0
commons-math-3.6.1,org.apache.commons.math3.fitting.leastsquares.LevenbergMarquardtOptimizer,15,10,5,10,0,66.67,0.0,410,390,20,390,0,0,95.12,0.0,355,304,85.63
commons-math-3.6.1,org.apache.commons.math3.fitting.leastsquares.LeastSquaresFactory$LocalLeastSquaresProblem,4,4,0,4,0,100.0,0.0,15,15,0,15,0,0,100.0,0.0,8,8,100.0
commons-math-3.6.1,org.apache.commons.math3.fitting.leastsquares.ParameterValidator,0,0,0,0,0,0.0,0.0,0,0,0,0,0,0,0.0,0.0,0,0,0
commons-math-3.6.1,org.apache.commons.math3.analysis.RealFieldUnivariateFunction,0,0,0,0,0,0.0,0.0,0,0,0,0,0,0,0.0,0.0,0,0,0
commons-math-3.6.1,org.apache.commons.math3.analysis.DifferentiableMultivariateVectorFunction,0,0,0,0,0,0.0,0.0,0,0,0,0,0,0,0.0,0.0,0,0,0
commons-math-3.6.1,org.apache.commons.math3.analysis.MultivariateVectorFunction,0,0,0,0,0,0.0,0.0,0,0,0,0,0,0,0.0,0.0,0,0,0
commons-math-3.6.1,org.apache.commons.math3.analysis.ParametricUnivariateFunction,0,0,0,0,0,0.0,0.0,0,0,0,0,0,0,0.0,0.0,0,0,0
commons-math-3.6.1,org.apache.commons.math3.analysis.MultivariateMatrixFunction,0,0,0,0,0,0.0,0.0,0,0,0,0,0,0,0.0,0.0,0,0,0
commons-math-3.6.1,org.apache.commons.math3.analysis.TrivariateFunction,0,0,0,0,0,0.0,0.0,0,0,0,0,0,0,0.0,0.0,0,0,0
commons-math-3.6.1,org.apache.commons.math3.analysis.UnivariateFunction,0,0,0,0,0,0.0,0.0,0,0,0,0,0,0,0.0,0.0,0,0,0
commons-math-3.6.1,org.apache.commons.math3.analysis.DifferentiableMultivariateFunction,0,0,0,0,0,0.0,0.0,0,0,0,0,0,0,0.0,0.0,0,0,0
commons-math-3.6.1,org.apache.commons.math3.analysis.MultivariateFunction,0,0,0,0,0,0.0,0.0,0,0,0,0,0,0,0.0,0.0,0,0,0
commons-math-3.6.1,org.apache.commons.math3.analysis.UnivariateVectorFunction,0,0,0,0,0,0.0,0.0,0,0,0,0,0,0,0.0,0.0,0,0,0
commons-math-3.6.1,org.apache.commons.math3.analysis.DifferentiableUnivariateVectorFunction,0,0,0,0,0,0.0,0.0,0,0,0,0,0,0,0.0,0.0,0,0,0
commons-math-3.6.1,org.apache.commons.math3.analysis.DifferentiableUnivariateFunction,0,0,0,0,0,0.0,0.0,0,0,0,0,0,0,0.0,0.0,0,0,0
commons-math-3.6.1,org.apache.commons.math3.analysis.BivariateFunction,0,0,0,0,0,0.0,0.0,0,0,0,0,0,0,0.0,0.0,0,0,0
commons-math-3.6.1,org.apache.commons.math3.analysis.DifferentiableUnivariateMatrixFunction,0,0,0,0,0,0.0,0.0,0,0,0,0,0,0,0.0,0.0,0,0,0
commons-math-3.6.1,org.apache.commons.math3.analysis.FunctionUtils,60,41,19,41,0,68.33,0.0,222,139,83,139,0,0,62.61,0.0,31,27,87.1
commons-math-3.6.1,org.apache.commons.math3.analysis.UnivariateMatrixFunction,0,0,0,0,0,0.0,0.0,0,0,0,0,0,0,0.0,0.0,0,0,0
commons-math-3.6.1,org.apache.commons.math3.analysis.integration.TrapezoidIntegrator,2,2,0,2,0,100.0,0.0,29,26,3,26,0,0,89.66,0.0,34,30,88.24
commons-math-3.6.1,org.apache.commons.math3.analysis.integration.UnivariateIntegrator,0,0,0,0,0,0.0,0.0,0,0,0,0,0,0,0.0,0.0,0,0,0
commons-math-3.6.1,org.apache.commons.math3.analysis.integration.BaseAbstractUnivariateIntegrator,12,12,0,12,0,100.0,0.0,35,33,2,33,0,0,94.29,0.0,15,13,86.67
commons-math-3.6.1,org.apache.commons.math3.analysis.integration.SimpsonIntegrator,1,1,0,1,0,100.0,0.0,22,17,5,17,0,0,77.27,0.0,20,12,60.0
commons-math-3.6.1,org.apache.commons.math3.analysis.integration.RombergIntegrator,1,1,0,1,0,100.0,0.0,27,24,3,24,0,0,88.89,0.0,24,19,79.17
commons-math-3.6.1,org.apache.commons.math3.analysis.integration.MidPointIntegrator,2,2,0,2,0,100.0,0.0,23,21,2,21,0,0,91.3,0.0,30,23,76.67
commons-math-3.6.1,org.apache.commons.math3.analysis.integration.LegendreGaussIntegrator,2,2,0,2,0,100.0,0.0,34,33,1,33,0,0,97.06,0.0,30,27,90.0
commons-math-3.6.1,org.apache.commons.math3.analysis.integration.IterativeLegendreGaussIntegrator,3,3,0,3,0,100.0,0.0,20,18,2,18,0,0,90.0,0.0,24,23,95.83
commons-math-3.6.1,org.apache.commons.math3.analysis.integration.gauss.GaussIntegrator,4,4,0,4,0,100.0,0.0,16,14,2,14,0,0,87.5,0.0,11,11,100.0
commons-math-3.6.1,org.apache.commons.math3.analysis.integration.gauss.SymmetricGaussIntegrator,1,1,0,1,0,100.0,0.0,13,13,0,13,0,0,100.0,0.0,19,17,89.47
commons-math-3.6.1,org.apache.commons.math3.analysis.integration.gauss.LegendreHighPrecisionRuleFactory,1,1,0,0,1,100.0,100.0,87,87,0,87,0,0,100.0,0.0,34,30,88.24
commons-math-3.6.1,org.apache.commons.math3.analysis.integration.gauss.LegendreRuleFactory,1,1,0,0,1,100.0,100.0,54,54,0,54,0,0,100.0,0.0,69,1,1.45
commons-math-3.6.1,org.apache.commons.math3.analysis.integration.gauss.GaussIntegratorFactory,7,5,2,5,0,71.43,0.0,11,9,2,9,0,0,81.82,0.0,15,15,100.0
commons-math-3.6.1,org.apache.commons.math3.analysis.integration.gauss.HermiteRuleFactory,1,1,0,0,1,100.0,100.0,54,54,0,54,0,0,100.0,0.0,67,67,100.0
commons-math-3.6.1,org.apache.commons.math3.analysis.integration.gauss.BaseRuleFactory,4,4,0,1,3,100.0,75.0,23,19,4,19,0,0,82.61,0.0,12,12,100.0
commons-math-3.6.1,org.apache.commons.math3.analysis.solvers.BracketedRealFieldUnivariateSolver,0,0,0,0,0,0.0,0.0,0,0,0,0,0,0,0.0,0.0,0,0,0
commons-math-3.6.1,org.apache.commons.math3.analysis.solvers.BracketingNthOrderBrentSolver,5,5,0,5,0,100.0,0.0,134,133,1,132,1,0,99.25,0.75,135,109,80.74
commons-math-3.6.1,org.apache.commons.math3.analysis.solvers.BaseSecantSolver$Method,0,0,0,0,0,0.0,0.0,0,0,0,0,0,0,0.0,0.0,0,0,0
commons-math-3.6.1,org.apache.commons.math3.analysis.solvers.UnivariateSolver,0,0,0,0,0,0.0,0.0,0,0,0,0,0,0,0.0,0.0,0,0,0
commons-math-3.6.1,org.apache.commons.math3.analysis.solvers.AbstractUnivariateSolver,0,0,0,0,0,0.0,0.0,0,0,0,0,0,0,0.0,0.0,0,0,0
commons-math-3.6.1,org.apache.commons.math3.analysis.solvers.BisectionSolver,1,1,0,1,0,100.0,0.0,16,16,0,16,0,0,100.0,0.0,8,5,62.5
commons-math-3.6.1,org.apache.commons.math3.analysis.solvers.RiddersSolver,1,1,0,1,0,100.0,0.0,44,36,8,36,0,0,81.82,0.0,33,21,63.64
commons-math-3.6.1,org.apache.commons.math3.analysis.solvers.NewtonSolver,2,2,0,2,0,100.0,0.0,9,9,0,9,0,0,100.0,0.0,7,6,85.71
commons-math-3.6.1,org.apache.commons.math3.analysis.solvers.RegulaFalsiSolver,0,0,0,0,0,0.0,0.0,0,0,0,0,0,0,0.0,0.0,0,0,0
commons-math-3.6.1,org.apache.commons.math3.analysis.solvers.AllowedSolution,0,0,0,0,0,0.0,0.0,0,0,0,0,0,0,0.0,0.0,0,0,0
commons-math-3.6.1,org.apache.commons.math3.analysis.solvers.PolynomialSolver,0,0,0,0,0,0.0,0.0,0,0,0,0,0,0,0.0,0.0,0,0,0
commons-math-3.6.1,org.apache.commons.math3.analysis.solvers.IllinoisSolver,0,0,0,0,0,0.0,0.0,0,0,0,0,0,0,0.0,0.0,0,0,0
commons-math-3.6.1,org.apache.commons.math3.analysis.solvers.LaguerreSolver,6,6,0,6,0,100.0,0.0,35,19,16,19,0,0,54.29,0.0,32,12,37.5
commons-math-3.6.1,org.apache.commons.math3.analysis.solvers.BrentSolver,2,2,0,2,0,100.0,0.0,82,82,0,82,0,0,100.0,0.0,86,63,73.26
commons-math-3.6.1,org.apache.commons.math3.analysis.solvers.BaseAbstractUnivariateSolver,19,18,1,17,1,94.74,5.26,32,31,1,31,0,0,96.88,0.0,26,24,92.31
commons-math-3.6.1,org.apache.commons.math3.analysis.solvers.MullerSolver,2,2,0,2,0,100.0,0.0,48,42,6,42,0,0,87.5,0.0,78,47,60.26
commons-math-3.6.1,org.apache.commons.math3.analysis.solvers.LaguerreSolver$ComplexSolver,3,3,0,2,1,100.0,33.33,58,49,9,49,0,0,84.48,0.0,43,32,74.42
commons-math-3.6.1,org.apache.commons.math3.analysis.solvers.AbstractPolynomialSolver,2,2,0,2,0,100.0,0.0,3,3,0,3,0,0,100.0,0.0,2,2,100.0
commons-math-3.6.1,org.apache.commons.math3.analysis.solvers.MullerSolver2,1,1,0,1,0,100.0,0.0,43,37,6,37,0,0,86.05,0.0,65,46,70.77
commons-math-3.6.1,org.apache.commons.math3.analysis.solvers.UnivariateDifferentiableSolver,0,0,0,0,0,0.0,0.0,0,0,0,0,0,0,0.0,0.0,0,0,0
commons-math-3.6.1,org.apache.commons.math3.analysis.solvers.DifferentiableUnivariateSolver,0,0,0,0,0,0.0,0.0,0,0,0,0,0,0,0.0,0.0,0,0,0
commons-math-3.6.1,org.apache.commons.math3.analysis.solvers.SecantSolver,1,1,0,1,0,100.0,0.0,26,24,2,24,0,0,92.31,0.0,20,16,80.0
commons-math-3.6.1,org.apache.commons.math3.analysis.solvers.BaseSecantSolver,4,4,0,4,0,100.0,0.0,74,71,3,71,0,0,95.95,0.0,55,38,69.09
commons-math-3.6.1,org.apache.commons.math3.analysis.solvers.NewtonRaphsonSolver,2,2,0,2,0,100.0,0.0,9,9,0,9,0,0,100.0,0.0,7,6,85.71
commons-math-3.6.1,org.apache.commons.math3.analysis.solvers.FieldBracketingNthOrderBrentSolver,9,6,3,6,0,66.67,0.0,141,113,28,113,0,0,80.14,0.0,112,77,68.75
commons-math-3.6.1,org.apache.commons.math3.analysis.solvers.UnivariateSolverUtils,12,12,0,12,0,100.0,0.0,102,69,33,63,6,3,67.65,5.88,92,50,54.35
commons-math-3.6.1,org.apache.commons.math3.analysis.solvers.BracketedUnivariateSolver,0,0,0,0,0,0.0,0.0,0,0,0,0,0,0,0.0,0.0,0,0,0
commons-math-3.6.1,org.apache.commons.math3.analysis.solvers.PegasusSolver,0,0,0,0,0,0.0,0.0,0,0,0,0,0,0,0.0,0.0,0,0,0
commons-math-3.6.1,org.apache.commons.math3.analysis.solvers.BaseUnivariateSolver,0,0,0,0,0,0.0,0.0,0,0,0,0,0,0,0.0,0.0,0,0,0
commons-math-3.6.1,org.apache.commons.math3.analysis.solvers.AbstractUnivariateDifferentiableSolver,2,2,0,2,0,100.0,0.0,4,4,0,4,0,0,100.0,0.0,3,3,100.0
commons-math-3.6.1,org.apache.commons.math3.analysis.solvers.AbstractDifferentiableUnivariateSolver,2,2,0,2,0,100.0,0.0,4,4,0,4,0,0,100.0,0.0,3,2,66.67
commons-math-3.6.1,org.apache.commons.math3.analysis.function.Logit$Parametric,3,3,0,3,0,100.0,0.0,10,9,1,9,0,0,90.0,0.0,10,5,50.0
commons-math-3.6.1,org.apache.commons.math3.analysis.function.Sin,3,3,0,3,0,100.0,0.0,3,3,0,3,0,0,100.0,0.0,3,3,100.0
commons-math-3.6.1,org.apache.commons.math3.analysis.function.Tan,3,1,2,0,1,33.33,33.33,3,1,2,1,0,0,33.33,0.0,3,0,0.0
commons-math-3.6.1,org.apache.commons.math3.analysis.function.HarmonicOscillator,4,3,1,3,0,75.0,0.0,15,14,1,14,0,0,93.33,0.0,22,21,95.45
commons-math-3.6.1,org.apache.commons.math3.analysis.function.Atanh,3,0,3,0,0,0.0,0.0,3,0,3,0,0,0,0.0,0.0,3,0,0.0
commons-math-3.6.1,org.apache.commons.math3.analysis.function.Sinc,3,2,1,2,0,66.67,0.0,47,46,1,46,0,0,97.87,0.0,95,73,76.84
commons-math-3.6.1,org.apache.commons.math3.analysis.function.Sigmoid,4,3,1,3,0,75.0,0.0,26,25,1,25,0,0,96.15,0.0,36,34,94.44
commons-math-3.6.1,org.apache.commons.math3.analysis.function.Floor,1,1,0,0,1,100.0,100.0,1,1,0,1,0,0,100.0,0.0,1,0,0.0
commons-math-3.6.1,org.apache.commons.math3.analysis.function.Logistic,4,3,1,3,0,75.0,0.0,13,12,1,12,0,0,92.31,0.0,12,11,91.67
commons-math-3.6.1,org.apache.commons.math3.analysis.function.Acos,3,1,2,0,1,33.33,33.33,3,1,2,1,0,0,33.33,0.0,3,0,0.0
commons-math-3.6.1,org.apache.commons.math3.analysis.function.Atan2,1,0,1,0,0,0.0,0.0,1,0,1,0,0,0,0.0,0.0,1,0,0.0
commons-math-3.6.1,org.apache.commons.math3.analysis.function.Gaussian$Parametric,3,3,0,3,0,100.0,0.0,13,13,0,13,0,0,100.0,0.0,22,22,100.0
commons-math-3.6.1,org.apache.commons.math3.analysis.function.Minus,3,2,1,2,0,66.67,0.0,3,2,1,2,0,0,66.67,0.0,4,3,75.0
commons-math-3.6.1,org.apache.commons.math3.analysis.function.Power,3,2,1,2,0,66.67,0.0,4,3,1,3,0,0,75.0,0.0,3,2,66.67
commons-math-3.6.1,org.apache.commons.math3.analysis.function.Log10,3,1,2,0,1,33.33,33.33,3,1,2,1,0,0,33.33,0.0,3,0,0.0
commons-math-3.6.1,org.apache.commons.math3.analysis.function.Sigmoid$Parametric,3,3,0,3,0,100.0,0.0,10,10,0,10,0,0,100.0,0.0,10,10,100.0
commons-math-3.6.1,org.apache.commons.math3.analysis.function.Ulp,1,1,0,0,1,100.0,100.0,1,1,0,1,0,0,100.0,0.0,1,0,0.0
commons-math-3.6.1,org.apache.commons.math3.analysis.function.Log,3,2,1,2,0,66.67,0.0,3,2,1,2,0,0,66.67,0.0,3,2,66.67
commons-math-3.6.1,org.apache.commons.math3.analysis.function.Divide,1,1,0,1,0,100.0,0.0,1,1,0,1,0,0,100.0,0.0,2,2,100.0
commons-math-3.6.1,org.apache.commons.math3.analysis.function.Abs,1,1,0,0,1,100.0,100.0,1,1,0,1,0,0,100.0,0.0,1,0,0.0
commons-math-3.6.1,org.apache.commons.math3.analysis.function.Expm1,3,1,2,1,0,33.33,0.0,3,1,2,1,0,0,33.33,0.0,3,1,33.33
commons-math-3.6.1,org.apache.commons.math3.analysis.function.HarmonicOscillator$Parametric,3,3,0,3,0,100.0,0.0,10,10,0,10,0,0,100.0,0.0,13,13,100.0
commons-math-3.6.1,org.apache.commons.math3.analysis.function.Min,1,1,0,1,0,100.0,0.0,1,1,0,1,0,0,100.0,0.0,1,1,100.0
commons-math-3.6.1,org.apache.commons.math3.analysis.function.Acosh,3,0,3,0,0,0.0,0.0,3,0,3,0,0,0,0.0,0.0,3,0,0.0
commons-math-3.6.1,org.apache.commons.math3.analysis.function.Max,1,1,0,1,0,100.0,0.0,1,1,0,1,0,0,100.0,0.0,1,1,100.0
commons-math-3.6.1,org.apache.commons.math3.analysis.function.Subtract,1,0,1,0,0,0.0,0.0,1,0,1,0,0,0,0.0,0.0,2,0,0.0
commons-math-3.6.1,org.apache.commons.math3.analysis.function.Sinh,3,1,2,0,1,33.33,33.33,3,1,2,1,0,0,33.33,0.0,3,0,0.0
commons-math-3.6.1,org.apache.commons.math3.analysis.function.Ceil,1,1,0,0,1,100.0,100.0,1,1,0,1,0,0,100.0,0.0,1,0,0.0
commons-math-3.6.1,org.apache.commons.math3.analysis.function.Logit,4,3,1,3,0,75.0,0.0,29,28,1,28,0,0,96.55,0.0,37,36,97.3
commons-math-3.6.1,org.apache.commons.math3.analysis.function.Signum,1,1,0,0,1,100.0,100.0,1,1,0,1,0,0,100.0,0.0,1,0,0.0
commons-math-3.6.1,org.apache.commons.math3.analysis.function.Identity,3,2,1,2,0,66.67,0.0,3,2,1,2,0,0,66.67,0.0,3,2,66.67
commons-math-3.6.1,org.apache.commons.math3.analysis.function.Constant,3,2,1,2,0,66.67,0.0,4,3,1,3,0,0,75.0,0.0,3,2,66.67
commons-math-3.6.1,org.apache.commons.math3.analysis.function.Log1p,3,1,2,0,1,33.33,33.33,3,1,2,1,0,0,33.33,0.0,3,0,0.0
commons-math-3.6.1,org.apache.commons.math3.analysis.function.Cbrt,3,1,2,0,1,33.33,33.33,3,1,2,1,0,0,33.33,0.0,3,0,0.0
commons-math-3.6.1,org.apache.commons.math3.analysis.function.Tanh,3,1,2,0,1,33.33,33.33,3,1,2,1,0,0,33.33,0.0,3,0,0.0
commons-math-3.6.1,org.apache.commons.math3.analysis.function.Exp,3,1,2,0,1,33.33,33.33,3,1,2,1,0,0,33.33,0.0,3,0,0.0
commons-math-3.6.1,org.apache.commons.math3.analysis.function.Pow,1,1,0,1,0,100.0,0.0,1,1,0,0,1,1,100.0,100.0,1,1,100.0
commons-math-3.6.1,org.apache.commons.math3.analysis.function.Gaussian,4,3,1,3,0,75.0,0.0,36,35,1,35,0,0,97.22,0.0,40,36,90.0
commons-math-3.6.1,org.apache.commons.math3.analysis.function.Inverse,3,2,1,2,0,66.67,0.0,3,2,1,2,0,0,66.67,0.0,4,3,75.0
commons-math-3.6.1,org.apache.commons.math3.analysis.function.Sqrt,3,2,1,2,0,66.67,0.0,3,2,1,2,0,0,66.67,0.0,3,2,66.67
commons-math-3.6.1,org.apache.commons.math3.analysis.function.Add,1,1,0,1,0,100.0,0.0,1,1,0,1,0,0,100.0,0.0,2,2,100.0
commons-math-3.6.1,org.apache.commons.math3.analysis.function.StepFunction,1,1,0,1,0,100.0,0.0,22,22,0,22,0,0,100.0,0.0,7,6,85.71
commons-math-3.6.1,org.apache.commons.math3.analysis.function.Cos,3,2,1,2,0,66.67,0.0,3,2,1,2,0,0,66.67,0.0,3,2,66.67
commons-math-3.6.1,org.apache.commons.math3.analysis.function.Logistic$Parametric,3,3,0,3,0,100.0,0.0,13,12,1,12,0,0,92.31,0.0,27,22,81.48
commons-math-3.6.1,org.apache.commons.math3.analysis.function.Rint,1,1,0,0,1,100.0,100.0,1,1,0,1,0,0,100.0,0.0,1,0,0.0
commons-math-3.6.1,org.apache.commons.math3.analysis.function.Asinh,3,0,3,0,0,0.0,0.0,3,0,3,0,0,0,0.0,0.0,3,0,0.0
commons-math-3.6.1,org.apache.commons.math3.analysis.function.Atan,3,1,2,0,1,33.33,33.33,3,1,2,1,0,0,33.33,0.0,3,0,0.0
commons-math-3.6.1,org.apache.commons.math3.analysis.function.Multiply,1,1,0,1,0,100.0,0.0,1,1,0,1,0,0,100.0,0.0,2,2,100.0
commons-math-3.6.1,org.apache.commons.math3.analysis.function.Asin,3,1,2,0,1,33.33,33.33,3,1,2,1,0,0,33.33,0.0,3,0,0.0
commons-math-3.6.1,org.apache.commons.math3.analysis.function.Cosh,3,2,1,1,1,66.67,33.33,3,2,1,2,0,0,66.67,0.0,3,1,33.33
commons-math-3.6.1,org.apache.commons.math3.analysis.differentiation.UnivariateDifferentiableFunction,0,0,0,0,0,0.0,0.0,0,0,0,0,0,0,0.0,0.0,0,0,0
commons-math-3.6.1,org.apache.commons.math3.analysis.differentiation.MultivariateDifferentiableVectorFunction,0,0,0,0,0,0.0,0.0,0,0,0,0,0,0,0.0,0.0,0,0,0
commons-math-3.6.1,org.apache.commons.math3.analysis.differentiation.FiniteDifferencesDifferentiator,12,12,0,10,2,100.0,16.67,83,83,0,81,2,0,100.0,2.41,24,22,91.67
commons-math-3.6.1,org.apache.commons.math3.analysis.differentiation.UnivariateVectorFunctionDifferentiator,0,0,0,0,0,0.0,0.0,0,0,0,0,0,0,0.0,0.0,0,0,0
commons-math-3.6.1,org.apache.commons.math3.analysis.differentiation.DerivativeStructure,77,77,0,77,0,100.0,0.0,218,218,0,218,0,0,100.0,0.0,194,170,87.63
commons-math-3.6.1,org.apache.commons.math3.analysis.differentiation.GradientFunction,1,1,0,1,0,100.0,0.0,10,10,0,10,0,0,100.0,0.0,5,5,100.0
commons-math-3.6.1,org.apache.commons.math3.analysis.differentiation.JacobianFunction,1,1,0,1,0,100.0,0.0,12,12,0,12,0,0,100.0,0.0,7,7,100.0
commons-math-3.6.1,org.apache.commons.math3.analysis.differentiation.MultivariateDifferentiableFunction,0,0,0,0,0,0.0,0.0,0,0,0,0,0,0,0.0,0.0,0,0,0
commons-math-3.6.1,org.apache.commons.math3.analysis.differentiation.UnivariateMatrixFunctionDifferentiator,0,0,0,0,0,0.0,0.0,0,0,0,0,0,0,0.0,0.0,0,0,0
commons-math-3.6.1,org.apache.commons.math3.analysis.differentiation.UnivariateFunctionDifferentiator,0,0,0,0,0,0.0,0.0,0,0,0,0,0,0,0.0,0.0,0,0,0
commons-math-3.6.1,org.apache.commons.math3.analysis.differentiation.SparseGradient,76,76,0,76,0,100.0,0.0,223,216,7,214,2,1,96.86,0.9,243,216,88.89
commons-math-3.6.1,org.apache.commons.math3.analysis.differentiation.DSCompiler,47,47,0,41,6,100.0,12.77,583,582,1,582,0,0,99.83,0.0,667,640,95.95
commons-math-3.6.1,org.apache.commons.math3.analysis.differentiation.UnivariateDifferentiableMatrixFunction,0,0,0,0,0,0.0,0.0,0,0,0,0,0,0,0.0,0.0,0,0,0
commons-math-3.6.1,org.apache.commons.math3.analysis.differentiation.UnivariateDifferentiableVectorFunction,0,0,0,0,0,0.0,0.0,0,0,0,0,0,0,0.0,0.0,0,0,0
commons-math-3.6.1,org.apache.commons.math3.analysis.differentiation.DerivativeStructure$DataTransferObject,1,1,0,1,0,100.0,0.0,4,4,0,4,0,0,100.0,0.0,1,1,100.0
commons-math-3.6.1,org.apache.commons.math3.analysis.polynomials.PolynomialFunction,16,13,3,12,1,81.25,6.25,129,96,33,91,5,0,74.42,3.88,100,68,68.0
commons-math-3.6.1,org.apache.commons.math3.analysis.polynomials.PolynomialsUtils,13,13,0,7,6,100.0,46.15,69,69,0,61,8,7,100.0,11.59,55,34,61.82
commons-math-3.6.1,org.apache.commons.math3.analysis.polynomials.PolynomialsUtils$RecurrenceCoefficientsGenerator,0,0,0,0,0,0.0,0.0,0,0,0,0,0,0,0.0,0.0,0,0,0
commons-math-3.6.1,org.apache.commons.math3.analysis.polynomials.PolynomialSplineFunction,8,7,1,7,0,87.5,0.0,54,41,13,41,0,0,75.93,0.0,42,30,71.43
commons-math-3.6.1,org.apache.commons.math3.analysis.polynomials.PolynomialsUtils$JacobiKey,2,2,0,0,2,100.0,100.0,7,5,2,0,5,0,71.43,71.43,9,2,22.22
commons-math-3.6.1,org.apache.commons.math3.analysis.polynomials.PolynomialFunctionLagrangeForm,9,6,3,6,0,66.67,0.0,88,74,14,74,0,0,84.09,0.0,87,70,80.46
commons-math-3.6.1,org.apache.commons.math3.analysis.polynomials.PolynomialFunctionNewtonForm,9,7,2,7,0,77.78,0.0,52,44,8,44,0,0,84.62,0.0,43,33,76.74
commons-math-3.6.1,org.apache.commons.math3.analysis.polynomials.PolynomialFunction$Parametric,2,2,0,2,0,100.0,0.0,7,7,0,7,0,0,100.0,0.0,5,5,100.0
commons-math-3.6.1,org.apache.commons.math3.analysis.interpolation.MicrosphereInterpolator,1,1,0,1,0,100.0,0.0,9,5,4,5,0,0,55.56,0.0,1,1,100.0
commons-math-3.6.1,org.apache.commons.math3.analysis.interpolation.PiecewiseBicubicSplineInterpolatingFunction,3,2,1,2,0,66.67,0.0,51,43,8,43,0,0,84.31,0.0,41,25,60.98
commons-math-3.6.1,org.apache.commons.math3.analysis.interpolation.MicrosphereInterpolatingFunction,2,2,0,1,1,100.0,50.0,45,33,12,33,0,0,73.33,0.0,16,13,81.25
commons-math-3.6.1,org.apache.commons.math3.analysis.interpolation.InterpolatingMicrosphere2D,1,0,1,0,0,0.0,0.0,4,3,1,3,0,0,75.0,0.0,1,0,0.0
commons-math-3.6.1,org.apache.commons.math3.analysis.interpolation.TricubicSplineFunction,1,1,0,1,0,100.0,0.0,25,19,6,19,0,0,76.0,0.0,29,25,86.21
commons-math-3.6.1,org.apache.commons.math3.analysis.interpolation.TricubicSplineInterpolator,3,3,0,1,2,100.0,66.67,66,64,2,64,0,0,96.97,0.0,68,34,50.0
commons-math-3.6.1,org.apache.commons.math3.analysis.interpolation.SplineInterpolator,1,1,0,1,0,100.0,0.0,33,33,0,33,0,0,100.0,0.0,64,63,98.44
commons-math-3.6.1,org.apache.commons.math3.analysis.interpolation.BicubicInterpolatingFunction,4,4,0,4,0,100.0,0.0,60,58,2,58,0,0,96.67,0.0,43,43,100.0
commons-math-3.6.1,org.apache.commons.math3.analysis.interpolation.PiecewiseBicubicSplineInterpolator,1,1,0,1,0,100.0,0.0,9,7,2,7,0,0,77.78,0.0,10,8,80.0
commons-math-3.6.1,org.apache.commons.math3.analysis.interpolation.SmoothingPolynomialBicubicSplineInterpolator,1,1,0,1,0,100.0,0.0,48,42,6,42,0,0,87.5,0.0,32,30,93.75
commons-math-3.6.1,org.apache.commons.math3.analysis.interpolation.UnivariateInterpolator,0,0,0,0,0,0.0,0.0,0,0,0,0,0,0,0.0,0.0,0,0,0
commons-math-3.6.1,org.apache.commons.math3.analysis.interpolation.BicubicInterpolator,2,2,0,2,0,100.0,0.0,20,18,2,18,0,0,90.0,0.0,28,26,92.86
commons-math-3.6.1,org.apache.commons.math3.analysis.interpolation.UnivariatePeriodicInterpolator,2,2,0,2,0,100.0,0.0,22,22,0,22,0,0,100.0,0.0,18,15,83.33
commons-math-3.6.1,org.apache.commons.math3.analysis.interpolation.BivariateGridInterpolator,0,0,0,0,0,0.0,0.0,0,0,0,0,0,0,0.0,0.0,0,0,0
commons-math-3.6.1,org.apache.commons.math3.analysis.interpolation.LinearInterpolator,1,1,0,1,0,100.0,0.0,17,17,0,17,0,0,100.0,0.0,15,14,93.33
commons-math-3.6.1,org.apache.commons.math3.analysis.interpolation.InterpolatingMicrosphere,8,6,2,6,0,75.0,0.0,73,48,25,48,0,0,65.75,0.0,40,30,75.0
commons-math-3.6.1,org.apache.commons.math3.analysis.interpolation.FieldHermiteInterpolator,3,3,0,3,0,100.0,0.0,61,61,0,61,0,0,100.0,0.0,45,41,91.11
commons-math-3.6.1,org.apache.commons.math3.analysis.interpolation.MicrosphereInterpolatingFunction$MicrosphereSurfaceElement,5,5,0,4,1,100.0,20.0,10,10,0,10,0,0,100.0,0.0,5,3,60.0
commons-math-3.6.1,org.apache.commons.math3.analysis.interpolation.TricubicSplineInterpolatingFunction,3,3,0,3,0,100.0,0.0,116,105,11,105,0,0,90.52,0.0,36,27,75.0
commons-math-3.6.1,org.apache.commons.math3.analysis.interpolation.MultivariateInterpolator,0,0,0,0,0,0.0,0.0,0,0,0,0,0,0,0.0,0.0,0,0,0
commons-math-3.6.1,org.apache.commons.math3.analysis.interpolation.BicubicSplineInterpolator,3,3,0,2,1,100.0,33.33,41,39,2,39,0,0,95.12,0.0,43,25,58.14
commons-math-3.6.1,org.apache.commons.math3.analysis.interpolation.AkimaSplineInterpolator,3,3,0,3,0,100.0,0.0,45,39,6,39,0,0,86.67,0.0,99,93,93.94
commons-math-3.6.1,org.apache.commons.math3.analysis.interpolation.InterpolatingMicrosphere$FacetData,2,2,0,2,0,100.0,0.0,4,4,0,4,0,0,100.0,0.0,2,2,100.0
commons-math-3.6.1,org.apache.commons.math3.analysis.interpolation.MicrosphereProjectionInterpolator,2,2,0,2,0,100.0,0.0,24,12,12,12,0,0,50.0,0.0,8,7,87.5
commons-math-3.6.1,org.apache.commons.math3.analysis.interpolation.TricubicFunction,1,1,0,1,0,100.0,0.0,25,19,6,19,0,0,76.0,0.0,29,29,100.0
commons-math-3.6.1,org.apache.commons.math3.analysis.interpolation.NevilleInterpolator,1,1,0,1,0,100.0,0.0,1,1,0,1,0,0,100.0,0.0,1,1,100.0
commons-math-3.6.1,org.apache.commons.math3.analysis.interpolation.TrivariateGridInterpolator,0,0,0,0,0,0.0,0.0,0,0,0,0,0,0,0.0,0.0,0,0,0
commons-math-3.6.1,org.apache.commons.math3.analysis.interpolation.TricubicInterpolatingFunction,4,3,1,3,0,75.0,0.0,120,105,15,105,0,0,87.5,0.0,53,30,56.6
commons-math-3.6.1,org.apache.commons.math3.analysis.interpolation.HermiteInterpolator,6,6,0,6,0,100.0,0.0,63,63,0,63,0,0,100.0,0.0,51,48,94.12
commons-math-3.6.1,org.apache.commons.math3.analysis.interpolation.InterpolatingMicrosphere$Facet,1,1,0,1,0,100.0,0.0,2,2,0,2,0,0,100.0,0.0,1,1,100.0
commons-math-3.6.1,org.apache.commons.math3.analysis.interpolation.DividedDifferenceInterpolator,2,2,0,2,0,100.0,0.0,12,12,0,12,0,0,100.0,0.0,14,14,100.0
commons-math-3.6.1,org.apache.commons.math3.analysis.interpolation.BicubicFunction,2,2,0,2,0,100.0,0.0,18,14,4,14,0,0,77.78,0.0,18,18,100.0
commons-math-3.6.1,org.apache.commons.math3.analysis.interpolation.BicubicSplineFunction,12,10,2,5,5,83.33,41.67,51,45,6,45,0,0,88.24,0.0,26,24,92.31
commons-math-3.6.1,org.apache.commons.math3.analysis.interpolation.LoessInterpolator,7,6,1,6,0,85.71,0.0,102,95,7,95,0,0,93.14,0.0,106,93,87.74
commons-math-3.6.1,org.apache.commons.math3.analysis.interpolation.BicubicSplineInterpolatingFunction,10,8,2,4,4,80.0,40.0,79,75,4,75,0,0,94.94,0.0,57,44,77.19
commons-math-3.6.1,org.apache.commons.math3.analysis.interpolation.TricubicInterpolator,2,1,1,1,0,50.0,0.0,33,27,6,27,0,0,81.82,0.0,59,53,89.83
commons-math-3.6.1,org.apache.commons.math3.util.MedianOf3PivotingStrategy,1,1,0,1,0,100.0,0.0,11,11,0,11,0,0,100.0,0.0,19,11,57.89
commons-math-3.6.1,org.apache.commons.math3.util.ArithmeticUtils,27,19,8,19,0,70.37,0.0,270,246,24,246,0,0,91.11,0.0,210,141,67.14
commons-math-3.6.1,org.apache.commons.math3.util.FastMath$Split,3,3,0,3,0,100.0,0.0,29,27,2,27,0,0,93.1,0.0,35,32,91.43
commons-math-3.6.1,org.apache.commons.math3.util.BigReal,17,13,4,11,2,76.47,11.76,44,40,4,39,1,0,90.91,2.27,20,16,80.0
commons-math-3.6.1,org.apache.commons.math3.util.FastMath$ExpFracTable,0,0,0,0,0,0.0,0.0,11,3,8,3,0,0,27.27,0.0,0,0,0
commons-math-3.6.1,org.apache.commons.math3.util.DefaultTransformer,3,2,1,1,1,66.67,33.33,14,13,1,11,2,0,92.86,14.29,9,6,66.67
commons-math-3.6.1,org.apache.commons.math3.util.Decimal64,69,60,9,60,0,86.96,0.0,95,82,13,73,9,7,86.32,9.47,100,90,90.0
commons-math-3.6.1,org.apache.commons.math3.util.IntegerSequence$Incrementor,15,13,2,13,0,86.67,0.0,33,29,4,29,0,0,87.88,0.0,30,21,70.0
commons-math-3.6.1,org.apache.commons.math3.util.CentralPivotingStrategy,1,0,1,0,0,0.0,0.0,2,0,2,0,0,0,0.0,0.0,5,0,0.0
commons-math-3.6.1,org.apache.commons.math3.util.PivotingStrategyInterface,0,0,0,0,0,0.0,0.0,0,0,0,0,0,0,0.0,0.0,0,0,0
commons-math-3.6.1,org.apache.commons.math3.util.CombinatoricsUtils,9,8,1,8,0,88.89,0.0,151,149,2,149,0,0,98.68,0.0,162,124,76.54
commons-math-3.6.1,org.apache.commons.math3.util.IterationListener,0,0,0,0,0,0.0,0.0,0,0,0,0,0,0,0.0,0.0,0,0,0
commons-math-3.6.1,org.apache.commons.math3.util.FastMathLiteralArrays,5,5,0,0,5,100.0,100.0,5,5,0,5,0,0,100.0,0.0,5,4,80.0
commons-math-3.6.1,org.apache.commons.math3.util.IntegerSequence$Incrementor$MaxCountExceededCallback,0,0,0,0,0,0.0,0.0,0,0,0,0,0,0,0.0,0.0,0,0,0
commons-math-3.6.1,org.apache.commons.math3.util.MultidimensionalCounter$Iterator,6,3,3,3,0,50.0,0.0,17,14,3,14,0,0,82.35,0.0,14,10,71.43
commons-math-3.6.1,org.apache.commons.math3.util.IntegerSequence,2,2,0,2,0,100.0,0.0,2,2,0,2,0,0,100.0,0.0,2,2,100.0
commons-math-3.6.1,org.apache.commons.math3.util.Combinations$SingletonIterator,3,2,1,2,0,66.67,0.0,8,6,2,6,0,0,75.0,0.0,4,4,100.0
commons-math-3.6.1,org.apache.commons.math3.util.TransformerMap,11,10,1,9,1,90.91,9.09,41,28,13,28,0,0,68.29,0.0,28,17,60.71
commons-math-3.6.1,org.apache.commons.math3.util.IterationEvent,1,1,0,1,0,100.0,0.0,2,2,0,2,0,0,100.0,0.0,1,1,100.0
commons-math-3.6.1,org.apache.commons.math3.util.MathArrays$OrderDirection,0,0,0,0,0,0.0,0.0,0,0,0,0,0,0,0.0,0.0,0,0,0
commons-math-3.6.1,org.apache.commons.math3.util.KthSelector,3,3,0,3,0,100.0,0.0,48,48,0,48,0,0,100.0,0.0,49,31,63.27
commons-math-3.6.1,org.apache.commons.math3.util.OpenIntToFieldHashMap$Iterator,4,4,0,4,0,100.0,0.0,30,22,8,22,0,0,73.33,0.0,16,15,93.75
commons-math-3.6.1,org.apache.commons.math3.util.CompositeFormat,8,8,0,8,0,100.0,0.0,51,51,0,51,0,0,100.0,0.0,40,35,87.5
commons-math-3.6.1,org.apache.commons.math3.util.MathArrays$PairDoubleInteger,2,2,0,2,0,100.0,0.0,4,4,0,4,0,0,100.0,0.0,2,2,100.0
commons-math-3.6.1,org.apache.commons.math3.util.IterationManager,11,8,3,7,1,72.73,9.09,19,14,5,14,0,0,73.68,0.0,7,4,57.14
commons-math-3.6.1,org.apache.commons.math3.util.ResizableDoubleArray$ExpansionMode,0,0,0,0,0,0.0,0.0,0,0,0,0,0,0,0.0,0.0,0,0,0
commons-math-3.6.1,org.apache.commons.math3.util.Combinations$LexicographicIterator,3,2,1,2,0,66.67,0.0,46,40,6,40,0,0,86.96,0.0,25,24,96.0
commons-math-3.6.1,org.apache.commons.math3.util.ContinuedFraction,4,2,2,2,0,50.0,0.0,40,26,14,26,0,0,65.0,0.0,24,15,62.5
commons-math-3.6.1,org.apache.commons.math3.util.OpenIntToDoubleHashMap$Iterator,4,4,0,4,0,100.0,0.0,30,22,8,22,0,0,73.33,0.0,16,15,93.75
commons-math-3.6.1,org.apache.commons.math3.util.RandomPivotingStrategy,1,0,1,0,0,0.0,0.0,3,1,2,1,0,0,33.33,0.0,5,0,0.0
commons-math-3.6.1,org.apache.commons.math3.util.NumberTransformer,0,0,0,0,0,0.0,0.0,0,0,0,0,0,0,0.0,0.0,0,0,0
commons-math-3.6.1,org.apache.commons.math3.util.FastMath$ExpIntTable,0,0,0,0,0,0.0,0.0,16,3,13,3,0,0,18.75,0.0,0,0,0
commons-math-3.6.1,org.apache.commons.math3.util.MathUtils,15,15,0,15,0,100.0,0.0,49,43,6,43,0,0,87.76,0.0,86,55,63.95
commons-math-3.6.1,org.apache.commons.math3.util.Combinations,4,4,0,4,0,100.0,0.0,13,12,1,12,0,0,92.31,0.0,7,7,100.0
commons-math-3.6.1,org.apache.commons.math3.util.Decimal64Field,4,4,0,4,0,100.0,0.0,4,4,0,4,0,0,100.0,0.0,4,4,100.0
commons-math-3.6.1,org.apache.commons.math3.util.BigRealField,5,4,1,4,0,80.0,0.0,5,4,1,4,0,0,80.0,0.0,5,4,80.0
commons-math-3.6.1,org.apache.commons.math3.util.ResizableDoubleArray,38,34,4,31,3,89.47,7.89,145,136,9,136,0,0,93.79,0.0,137,99,72.26
commons-math-3.6.1,org.apache.commons.math3.util.MathArrays$Position,0,0,0,0,0,0.0,0.0,0,0,0,0,0,0,0.0,0.0,0,0,0
commons-math-3.6.1,org.apache.commons.math3.util.FastMath$lnMant,0,0,0,0,0,0.0,0.0,7,2,5,2,0,0,28.57,0.0,0,0,0
commons-math-3.6.1,org.apache.commons.math3.util.FastMath,89,83,6,83,0,93.26,0.0,1565,1466,99,1466,0,0,93.67,0.0,2440,2067,84.71
commons-math-3.6.1,org.apache.commons.math3.util.FastMathCalc,16,0,16,0,0,0.0,0.0,267,0,267,0,0,0,0.0,0.0,235,0,0.0
commons-math-3.6.1,org.apache.commons.math3.util.Pair,8,8,0,8,0,100.0,0.0,19,17,2,15,2,2,89.47,10.53,24,18,75.0
commons-math-3.6.1,org.apache.commons.math3.util.MathArrays$Function,0,0,0,0,0,0.0,0.0,0,0,0,0,0,0,0.0,0.0,0,0,0
commons-math-3.6.1,org.apache.commons.math3.util.Combinations$IterationOrder,0,0,0,0,0,0.0,0.0,0,0,0,0,0,0,0.0,0.0,0,0,0
commons-math-3.6.1,org.apache.commons.math3.util.MathArrays,61,57,4,55,2,93.44,3.28,479,436,43,436,0,0,91.02,0.0,599,493,82.3
commons-math-3.6.1,org.apache.commons.math3.util.Combinations$LexicographicComparator,2,2,0,2,0,100.0,0.0,25,25,0,25,0,0,100.0,0.0,20,19,95.0
commons-math-3.6.1,org.apache.commons.math3.util.BigRealField$LazyHolder,0,0,0,0,0,0.0,0.0,0,0,0,0,0,0,0.0,0.0,0,0,0
commons-math-3.6.1,org.apache.commons.math3.util.OpenIntToFieldHashMap,20,19,1,15,4,95.0,20.0,157,155,2,155,0,0,98.73,0.0,112,76,67.86
commons-math-3.6.1,org.apache.commons.math3.util.OpenIntToDoubleHashMap,19,19,0,17,2,100.0,10.53,154,154,0,152,2,2,100.0,1.3,111,75,67.57
commons-math-3.6.1,org.apache.commons.math3.util.Incrementor,12,9,3,8,1,75.0,8.33,27,19,8,19,0,0,70.37,0.0,13,12,92.31
commons-math-3.6.1,org.apache.commons.math3.util.FastMath$CodyWaite,3,3,0,3,0,100.0,0.0,24,24,0,24,0,0,100.0,0.0,3,3,100.0
commons-math-3.6.1,org.apache.commons.math3.util.DoubleArray,0,0,0,0,0,0.0,0.0,0,0,0,0,0,0,0.0,0.0,0,0,0
commons-math-3.6.1,org.apache.commons.math3.util.Incrementor$MaxCountExceededCallback,0,0,0,0,0,0.0,0.0,0,0,0,0,0,0,0.0,0.0,0,0,0
commons-math-3.6.1,org.apache.commons.math3.util.IntegerSequence$Range,2,2,0,2,0,100.0,0.0,6,6,0,6,0,0,100.0,0.0,5,4,80.0
commons-math-3.6.1,org.apache.commons.math3.util.MultidimensionalCounter,7,6,1,6,0,85.71,0.0,53,49,4,49,0,0,92.45,0.0,33,27,81.82
commons-math-3.6.1,org.apache.commons.math3.util.Precision,21,18,3,16,2,85.71,9.52,117,114,3,113,1,0,97.44,0.85,149,108,72.48
commons-math-3.6.1,org.apache.commons.math3.complex.ComplexUtils,2,2,0,2,0,100.0,0.0,8,8,0,8,0,0,100.0,0.0,8,8,100.0
commons-math-3.6.1,org.apache.commons.math3.complex.Complex,46,43,3,43,0,93.48,0.0,246,232,14,204,28,16,94.31,11.38,301,272,90.37
commons-math-3.6.1,org.apache.commons.math3.complex.Quaternion,26,25,1,25,0,96.15,0.0,56,51,5,51,0,0,91.07,0.0,129,118,91.47
commons-math-3.6.1,org.apache.commons.math3.complex.ComplexField$LazyHolder,0,0,0,0,0,0.0,0.0,0,0,0,0,0,0,0.0,0.0,0,0,0
commons-math-3.6.1,org.apache.commons.math3.complex.RootsOfUnity,5,5,0,5,0,100.0,0.0,43,39,4,39,0,0,90.7,0.0,37,29,78.38
commons-math-3.6.1,org.apache.commons.math3.complex.ComplexField,5,4,1,4,0,80.0,0.0,5,4,1,4,0,0,80.0,0.0,5,4,80.0
commons-math-3.6.1,org.apache.commons.math3.complex.ComplexFormat,14,11,3,11,0,78.57,0.0,113,72,41,72,0,0,63.72,0.0,40,25,62.5
commons-math-3.6.1,org.apache.commons.math3.optimization.DifferentiableMultivariateVectorMultiStartOptimizer,0,0,0,0,0,0.0,0.0,0,0,0,0,0,0,0.0,0.0,0,0,0
commons-math-3.6.1,org.apache.commons.math3.optimization.MultivariateDifferentiableMultiStartOptimizer,0,0,0,0,0,0.0,0.0,0,0,0,0,0,0,0.0,0.0,0,0,0
commons-math-3.6.1,org.apache.commons.math3.optimization.BaseMultivariateVectorOptimizer,0,0,0,0,0,0.0,0.0,0,0,0,0,0,0,0.0,0.0,0,0,0
commons-math-3.6.1,org.apache.commons.math3.optimization.OptimizationData,0,0,0,0,0,0.0,0.0,0,0,0,0,0,0,0.0,0.0,0,0,0
commons-math-3.6.1,org.apache.commons.math3.optimization.MultivariateMultiStartOptimizer,0,0,0,0,0,0.0,0.0,0,0,0,0,0,0,0.0,0.0,0,0,0
commons-math-3.6.1,org.apache.commons.math3.optimization.Weight,1,1,0,1,0,100.0,0.0,6,2,4,2,0,0,33.33,0.0,1,1,100.0
commons-math-3.6.1,org.apache.commons.math3.optimization.Target,1,1,0,1,0,100.0,0.0,2,2,0,2,0,0,100.0,0.0,1,1,100.0
commons-math-3.6.1,org.apache.commons.math3.optimization.MultivariateDifferentiableVectorOptimizer,0,0,0,0,0,0.0,0.0,0,0,0,0,0,0,0.0,0.0,0,0,0
commons-math-3.6.1,org.apache.commons.math3.optimization.PointValuePair$DataTransferObject,1,1,0,1,0,100.0,0.0,3,3,0,3,0,0,100.0,0.0,1,1,100.0
commons-math-3.6.1,org.apache.commons.math3.optimization.MultivariateDifferentiableOptimizer,0,0,0,0,0,0.0,0.0,0,0,0,0,0,0,0.0,0.0,0,0,0
commons-math-3.6.1,org.apache.commons.math3.optimization.BaseMultivariateMultiStartOptimizer,7,6,1,4,2,85.71,28.57,40,25,15,25,0,0,62.5,0.0,14,10,71.43
commons-math-3.6.1,org.apache.commons.math3.optimization.ConvergenceChecker,0,0,0,0,0,0.0,0.0,0,0,0,0,0,0,0.0,0.0,0,0,0
commons-math-3.6.1,org.apache.commons.math3.optimization.BaseMultivariateOptimizer,0,0,0,0,0,0.0,0.0,0,0,0,0,0,0,0.0,0.0,0,0,0
commons-math-3.6.1,org.apache.commons.math3.optimization.GoalType,0,0,0,0,0,0.0,0.0,0,0,0,0,0,0,0.0,0.0,0,0,0
commons-math-3.6.1,org.apache.commons.math3.optimization.MultivariateOptimizer,0,0,0,0,0,0.0,0.0,0,0,0,0,0,0,0.0,0.0,0,0,0
commons-math-3.6.1,org.apache.commons.math3.optimization.BaseOptimizer,0,0,0,0,0,0.0,0.0,0,0,0,0,0,0,0.0,0.0,0,0,0
commons-math-3.6.1,org.apache.commons.math3.optimization.SimpleVectorValueChecker,1,1,0,1,0,100.0,0.0,15,14,1,14,0,0,93.33,0.0,14,12,85.71
commons-math-3.6.1,org.apache.commons.math3.optimization.SimplePointChecker,1,1,0,1,0,100.0,0.0,15,14,1,14,0,0,93.33,0.0,14,12,85.71
commons-math-3.6.1,org.apache.commons.math3.optimization.DifferentiableMultivariateMultiStartOptimizer,0,0,0,0,0,0.0,0.0,0,0,0,0,0,0,0.0,0.0,0,0,0
commons-math-3.6.1,org.apache.commons.math3.optimization.MultivariateDifferentiableVectorMultiStartOptimizer,0,0,0,0,0,0.0,0.0,0,0,0,0,0,0,0.0,0.0,0,0,0
commons-math-3.6.1,org.apache.commons.math3.optimization.PointVectorValuePair,5,5,0,5,0,100.0,0.0,5,5,0,5,0,0,100.0,0.0,7,7,100.0
commons-math-3.6.1,org.apache.commons.math3.optimization.SimpleBounds,2,2,0,2,0,100.0,0.0,4,4,0,4,0,0,100.0,0.0,2,2,100.0
commons-math-3.6.1,org.apache.commons.math3.optimization.BaseMultivariateVectorMultiStartOptimizer,8,7,1,4,3,87.5,37.5,46,38,8,38,0,0,82.61,0.0,14,9,64.29
commons-math-3.6.1,org.apache.commons.math3.optimization.InitialGuess,1,1,0,1,0,100.0,0.0,2,2,0,2,0,0,100.0,0.0,1,1,100.0
commons-math-3.6.1,org.apache.commons.math3.optimization.AbstractConvergenceChecker,2,2,0,2,0,100.0,0.0,6,4,2,4,0,0,66.67,0.0,2,2,100.0
commons-math-3.6.1,org.apache.commons.math3.optimization.SimpleValueChecker,1,1,0,1,0,100.0,0.0,10,9,1,9,0,0,90.0,0.0,11,9,81.82
commons-math-3.6.1,org.apache.commons.math3.optimization.DifferentiableMultivariateOptimizer,0,0,0,0,0,0.0,0.0,0,0,0,0,0,0,0.0,0.0,0,0,0
commons-math-3.6.1,org.apache.commons.math3.optimization.PointValuePair,3,3,0,3,0,100.0,0.0,3,3,0,3,0,0,100.0,0.0,4,4,100.0
commons-math-3.6.1,org.apache.commons.math3.optimization.BaseMultivariateSimpleBoundsOptimizer,0,0,0,0,0,0.0,0.0,0,0,0,0,0,0,0.0,0.0,0,0,0
commons-math-3.6.1,org.apache.commons.math3.optimization.LeastSquaresConverter,1,1,0,1,0,100.0,0.0,37,31,6,31,0,0,83.78,0.0,16,16,100.0
commons-math-3.6.1,org.apache.commons.math3.optimization.PointVectorValuePair$DataTransferObject,1,1,0,1,0,100.0,0.0,3,3,0,3,0,0,100.0,0.0,1,1,100.0
commons-math-3.6.1,org.apache.commons.math3.optimization.DifferentiableMultivariateVectorOptimizer,0,0,0,0,0,0.0,0.0,0,0,0,0,0,0,0.0,0.0,0,0,0
commons-math-3.6.1,org.apache.commons.math3.optimization.fitting.CurveFitter$TheoreticalValuesFunction,2,0,2,0,0,0.0,0.0,16,0,16,0,0,0,0.0,0.0,8,0,0.0
commons-math-3.6.1,org.apache.commons.math3.optimization.fitting.CurveFitter$OldTheoreticalValuesFunction,3,3,0,3,0,100.0,0.0,10,10,0,10,0,0,100.0,0.0,3,3,100.0
commons-math-3.6.1,org.apache.commons.math3.optimization.fitting.GaussianFitter$ParameterGuesser,8,8,0,7,1,100.0,12.5,74,43,31,43,0,0,58.11,0.0,55,42,76.36
commons-math-3.6.1,org.apache.commons.math3.optimization.fitting.HarmonicFitter$ParameterGuesser,4,4,0,4,0,100.0,0.0,85,83,2,83,0,0,97.65,0.0,90,63,70.0
commons-math-3.6.1,org.apache.commons.math3.optimization.fitting.GaussianFitter,4,4,0,4,0,100.0,0.0,10,10,0,10,0,0,100.0,0.0,2,2,100.0
commons-math-3.6.1,org.apache.commons.math3.optimization.fitting.WeightedObservedPoint,3,3,0,2,1,100.0,33.33,6,6,0,6,0,0,100.0,0.0,3,3,100.0
commons-math-3.6.1,org.apache.commons.math3.optimization.fitting.HarmonicFitter,2,2,0,2,0,100.0,0.0,2,2,0,2,0,0,100.0,0.0,2,2,100.0
commons-math-3.6.1,org.apache.commons.math3.optimization.fitting.PolynomialFitter,3,1,2,1,0,33.33,0.0,5,2,3,2,0,0,40.0,0.0,4,1,25.0
commons-math-3.6.1,org.apache.commons.math3.optimization.fitting.CurveFitter,7,5,2,5,0,71.43,0.0,24,18,6,18,0,0,75.0,0.0,7,6,85.71
commons-math-3.6.1,org.apache.commons.math3.optimization.direct.MultiDirectionalSimplex,2,2,0,2,0,100.0,0.0,22,22,0,22,0,0,100.0,0.0,16,14,87.5
commons-math-3.6.1,org.apache.commons.math3.optimization.direct.CMAESOptimizer$FitnessFunction,5,4,1,2,2,80.0,40.0,34,24,10,24,0,0,70.59,0.0,29,15,51.72
commons-math-3.6.1,org.apache.commons.math3.optimization.direct.MultivariateFunctionMappingAdapter$Mapper,0,0,0,0,0,0.0,0.0,0,0,0,0,0,0,0.0,0.0,0,0,0
commons-math-3.6.1,org.apache.commons.math3.optimization.direct.PowellOptimizer,2,2,0,2,0,100.0,0.0,71,65,6,65,0,0,91.55,0.0,53,24,45.28
commons-math-3.6.1,org.apache.commons.math3.optimization.direct.BaseAbstractMultivariateOptimizer,14,14,0,14,0,100.0,0.0,66,64,2,64,0,0,96.97,0.0,41,40,97.56
commons-math-3.6.1,org.apache.commons.math3.optimization.direct.MultivariateFunctionMappingAdapter$LowerUpperBoundMapper,2,2,0,2,0,100.0,0.0,4,4,0,4,0,0,100.0,0.0,2,2,100.0
commons-math-3.6.1,org.apache.commons.math3.optimization.direct.MultivariateFunctionPenaltyAdapter,1,1,0,1,0,100.0,0.0,36,30,6,30,0,0,83.33,0.0,20,16,80.0
commons-math-3.6.1,org.apache.commons.math3.optimization.direct.BOBYQAOptimizer$PathIsExploredException,0,0,0,0,0,0.0,0.0,0,0,0,0,0,0,0.0,0.0,0,0,0
commons-math-3.6.1,org.apache.commons.math3.optimization.direct.CMAESOptimizer$PopulationSize,1,1,0,0,1,100.0,100.0,5,3,2,3,0,0,60.0,0.0,1,0,0.0
commons-math-3.6.1,org.apache.commons.math3.optimization.direct.CMAESOptimizer,38,32,6,29,3,84.21,7.89,386,341,45,341,0,0,88.34,0.0,406,239,58.87
commons-math-3.6.1,org.apache.commons.math3.optimization.direct.BaseAbstractMultivariateVectorOptimizer,17,11,6,11,0,64.71,0.0,59,38,21,38,0,0,64.41,0.0,31,18,58.06
commons-math-3.6.1,org.apache.commons.math3.optimization.direct.CMAESOptimizer$DoubleIndex,3,1,2,1,0,33.33,0.0,12,3,9,3,0,0,25.0,0.0,12,1,8.33
commons-math-3.6.1,org.apache.commons.math3.optimization.direct.PowellOptimizer$LineSearch,2,2,0,2,0,100.0,0.0,6,6,0,6,0,0,100.0,0.0,2,2,100.0
commons-math-3.6.1,org.apache.commons.math3.optimization.direct.MultivariateFunctionMappingAdapter$NoBoundsMapper,2,2,0,2,0,100.0,0.0,2,2,0,2,0,0,100.0,0.0,2,2,100.0
commons-math-3.6.1,org.apache.commons.math3.optimization.direct.CMAESOptimizer$Sigma,1,1,0,1,0,100.0,0.0,7,7,0,7,0,0,100.0,0.0,1,1,100.0
commons-math-3.6.1,org.apache.commons.math3.optimization.direct.BaseAbstractMultivariateSimpleBoundsOptimizer,2,2,0,2,0,100.0,0.0,2,2,0,2,0,0,100.0,0.0,2,2,100.0
commons-math-3.6.1,org.apache.commons.math3.optimization.direct.MultivariateFunctionMappingAdapter,3,3,0,3,0,100.0,0.0,33,29,4,29,0,0,87.88,0.0,7,7,100.0
commons-math-3.6.1,org.apache.commons.math3.optimization.direct.MultivariateFunctionMappingAdapter$UpperBoundMapper,2,2,0,2,0,100.0,0.0,3,3,0,3,0,0,100.0,0.0,6,5,83.33
commons-math-3.6.1,org.apache.commons.math3.optimization.direct.NelderMeadSimplex,1,1,0,1,0,100.0,0.0,58,58,0,58,0,0,100.0,0.0,58,53,91.38
commons-math-3.6.1,org.apache.commons.math3.optimization.direct.BOBYQAOptimizer,9,8,1,8,0,88.89,0.0,1286,1086,200,1086,0,0,84.45,0.0,1440,903,62.71
commons-math-3.6.1,org.apache.commons.math3.optimization.direct.SimplexOptimizer,6,6,0,6,0,100.0,0.0,32,30,2,30,0,0,93.75,0.0,18,17,94.44
commons-math-3.6.1,org.apache.commons.math3.optimization.direct.MultivariateFunctionMappingAdapter$LowerBoundMapper,2,2,0,2,0,100.0,0.0,3,3,0,3,0,0,100.0,0.0,4,3,75.0
commons-math-3.6.1,org.apache.commons.math3.optimization.direct.AbstractSimplex,10,10,0,10,0,100.0,0.0,88,68,20,68,0,0,77.27,0.0,35,29,82.86
commons-math-3.6.1,org.apache.commons.math3.optimization.general.ConjugateGradientFormula,0,0,0,0,0,0.0,0.0,0,0,0,0,0,0,0.0,0.0,0,0,0
commons-math-3.6.1,org.apache.commons.math3.optimization.general.NonLinearConjugateGradientOptimizer$IdentityPreconditioner,1,1,0,1,0,100.0,0.0,1,1,0,1,0,0,100.0,0.0,1,1,100.0
commons-math-3.6.1,org.apache.commons.math3.optimization.general.NonLinearConjugateGradientOptimizer,3,2,1,2,0,66.67,0.0,69,62,7,62,0,0,89.86,0.0,52,44,84.62
commons-math-3.6.1,org.apache.commons.math3.optimization.general.AbstractScalarDifferentiableOptimizer,3,3,0,3,0,100.0,0.0,4,4,0,4,0,0,100.0,0.0,3,3,100.0
commons-math-3.6.1,org.apache.commons.math3.optimization.general.GaussNewtonOptimizer,1,1,0,1,0,100.0,0.0,42,39,3,39,0,0,92.86,0.0,26,26,100.0
commons-math-3.6.1,org.apache.commons.math3.optimization.general.AbstractDifferentiableOptimizer,3,0,3,0,0,0.0,0.0,4,0,4,0,0,0,0.0,0.0,3,0,0.0
commons-math-3.6.1,org.apache.commons.math3.optimization.general.AbstractLeastSquaresOptimizer,20,16,4,15,1,80.0,5.0,66,57,9,57,0,0,86.36,0.0,45,35,77.78
commons-math-3.6.1,org.apache.commons.math3.optimization.general.LevenbergMarquardtOptimizer,5,5,0,5,0,100.0,0.0,424,406,18,406,0,0,95.75,0.0,343,292,85.13
commons-math-3.6.1,org.apache.commons.math3.optimization.general.Preconditioner,0,0,0,0,0,0.0,0.0,0,0,0,0,0,0,0.0,0.0,0,0,0
commons-math-3.6.1,org.apache.commons.math3.optimization.general.NonLinearConjugateGradientOptimizer$LineSearchFunction,1,1,0,1,0,100.0,0.0,9,9,0,9,0,0,100.0,0.0,9,8,88.89
commons-math-3.6.1,org.apache.commons.math3.optimization.linear.Relationship,2,1,1,1,0,50.0,0.0,6,5,1,5,0,0,83.33,0.0,4,2,50.0
commons-math-3.6.1,org.apache.commons.math3.optimization.linear.LinearObjectiveFunction,8,6,2,4,2,75.0,25.0,19,14,5,14,0,0,73.68,0.0,19,10,52.63
commons-math-3.6.1,org.apache.commons.math3.optimization.linear.SimplexTableau,30,27,3,26,1,90.0,3.33,188,182,6,182,0,0,96.81,0.0,173,146,84.39
commons-math-3.6.1,org.apache.commons.math3.optimization.linear.UnboundedSolutionException,0,0,0,0,0,0.0,0.0,0,0,0,0,0,0,0.0,0.0,0,0,0
commons-math-3.6.1,org.apache.commons.math3.optimization.linear.LinearOptimizer,0,0,0,0,0,0.0,0.0,0,0,0,0,0,0,0.0,0.0,0,0,0
commons-math-3.6.1,org.apache.commons.math3.optimization.linear.SimplexSolver,5,5,0,5,0,100.0,0.0,80,80,0,80,0,0,100.0,0.0,56,38,67.86
commons-math-3.6.1,org.apache.commons.math3.optimization.linear.LinearConstraint,7,6,1,5,1,85.71,14.29,29,15,14,15,0,0,51.72,0.0,18,11,61.11
commons-math-3.6.1,org.apache.commons.math3.optimization.linear.AbstractLinearOptimizer,9,9,0,8,1,100.0,11.11,17,15,2,15,0,0,88.24,0.0,11,8,72.73
commons-math-3.6.1,org.apache.commons.math3.optimization.linear.NoFeasibleSolutionException,0,0,0,0,0,0.0,0.0,0,0,0,0,0,0,0.0,0.0,0,0,0
commons-math-3.6.1,org.apache.commons.math3.optimization.univariate.UnivariateOptimizer,0,0,0,0,0,0.0,0.0,0,0,0,0,0,0,0.0,0.0,0,0,0
commons-math-3.6.1,org.apache.commons.math3.optimization.univariate.BracketFinder,10,5,5,5,0,50.0,0.0,95,75,20,75,0,0,78.95,0.0,86,24,27.91
commons-math-3.6.1,org.apache.commons.math3.optimization.univariate.UnivariatePointValuePair,2,2,0,2,0,100.0,0.0,4,4,0,4,0,0,100.0,0.0,2,2,100.0
commons-math-3.6.1,org.apache.commons.math3.optimization.univariate.SimpleUnivariateValueChecker,1,1,0,1,0,100.0,0.0,10,9,1,9,0,0,90.0,0.0,11,9,81.82
commons-math-3.6.1,org.apache.commons.math3.optimization.univariate.BaseAbstractUnivariateOptimizer,10,10,0,10,0,100.0,0.0,27,23,4,23,0,0,85.19,0.0,18,18,100.0
commons-math-3.6.1,org.apache.commons.math3.optimization.univariate.BaseUnivariateOptimizer,0,0,0,0,0,0.0,0.0,0,0,0,0,0,0,0.0,0.0,0,0,0
commons-math-3.6.1,org.apache.commons.math3.optimization.univariate.UnivariateMultiStartOptimizer,8,6,2,6,0,75.0,0.0,40,30,10,30,0,0,75.0,0.0,21,18,85.71
commons-math-3.6.1,org.apache.commons.math3.optimization.univariate.BrentOptimizer,2,2,0,2,0,100.0,0.0,124,114,10,114,0,0,91.94,0.0,111,92,82.88
commons-math-3.6.1,org.apache.commons.math3.linear.SparseRealVector,0,0,0,0,0,0.0,0.0,0,0,0,0,0,0,0.0,0.0,0,0,0
commons-math-3.6.1,org.apache.commons.math3.linear.RealVectorChangingVisitor,0,0,0,0,0,0.0,0.0,0,0,0,0,0,0,0.0,0.0,0,0,0
commons-math-3.6.1,org.apache.commons.math3.linear.SchurTransformer,9,9,0,8,1,100.0,11.11,204,202,2,202,0,0,99.02,0.0,274,234,85.4
commons-math-3.6.1,org.apache.commons.math3.linear.RealMatrix,0,0,0,0,0,0.0,0.0,0,0,0,0,0,0,0.0,0.0,0,0,0
commons-math-3.6.1,org.apache.commons.math3.linear.AbstractFieldMatrix,63,57,6,57,0,90.48,0.0,415,353,62,353,0,0,85.06,0.0,350,253,72.29
commons-math-3.6.1,org.apache.commons.math3.linear.RRQRDecomposition,5,5,0,5,0,100.0,0.0,50,50,0,50,0,0,100.0,0.0,30,19,63.33
commons-math-3.6.1,org.apache.commons.math3.linear.RealLinearOperator,2,0,2,0,0,0.0,0.0,2,0,2,0,0,0,0.0,0.0,1,0,0.0
commons-math-3.6.1,org.apache.commons.math3.linear.JacobiPreconditioner,8,6,2,6,0,75.0,0.0,22,18,4,18,0,0,81.82,0.0,13,12,92.31
commons-math-3.6.1,org.apache.commons.math3.linear.DefaultFieldMatrixChangingVisitor,2,1,1,0,1,50.0,50.0,3,2,1,2,0,0,66.67,0.0,2,0,0.0
commons-math-3.6.1,org.apache.commons.math3.linear.FieldMatrixChangingVisitor,0,0,0,0,0,0.0,0.0,0,0,0,0,0,0,0.0,0.0,0,0,0
commons-math-3.6.1,org.apache.commons.math3.linear.MatrixUtils$BigFractionMatrixConverter,3,3,0,3,0,100.0,0.0,3,3,0,3,0,0,100.0,0.0,1,1,100.0
commons-math-3.6.1,org.apache.commons.math3.linear.RectangularCholeskyDecomposition,2,2,0,2,0,100.0,0.0,52,48,4,48,0,0,92.31,0.0,2,2,100.0
commons-math-3.6.1,org.apache.commons.math3.linear.HessenbergTransformer,5,4,1,4,0,80.0,0.0,89,88,1,88,0,0,98.88,0.0,89,84,94.38
commons-math-3.6.1,org.apache.commons.math3.linear.IterativeLinearSolverEvent,2,0,2,0,0,0.0,0.0,2,0,2,0,0,0,0.0,0.0,1,0,0.0
commons-math-3.6.1,org.apache.commons.math3.linear.DiagonalMatrix,21,21,0,21,0,100.0,0.0,80,79,1,74,5,4,98.75,6.25,61,53,86.89
commons-math-3.6.1,org.apache.commons.math3.linear.DefaultRealMatrixPreservingVisitor,1,1,0,1,0,100.0,0.0,1,1,0,1,0,0,100.0,0.0,0,0,0
commons-math-3.6.1,org.apache.commons.math3.linear.DefaultIterativeLinearSolverEvent,5,4,1,4,0,80.0,0.0,16,14,2,13,1,1,87.5,6.25,7,5,71.43
commons-math-3.6.1,org.apache.commons.math3.linear.IllConditionedOperatorException,0,0,0,0,0,0.0,0.0,0,0,0,0,0,0,0.0,0.0,0,0,0
commons-math-3.6.1,org.apache.commons.math3.linear.RealVectorFormat,11,7,4,6,1,63.64,9.09,62,58,4,58,0,0,93.55,0.0,32,24,75.0
commons-math-3.6.1,org.apache.commons.math3.linear.SparseFieldVector,47,38,9,33,5,80.85,10.64,290,209,81,185,24,3,72.07,8.28,211,108,51.18
commons-math-3.6.1,org.apache.commons.math3.linear.SymmLQ,10,6,4,6,0,60.0,0.0,47,36,11,35,1,1,76.6,2.13,37,21,56.76
commons-math-3.6.1,org.apache.commons.math3.linear.RealVector$UnmodifiableEntry,2,2,0,2,0,100.0,0.0,2,2,0,2,0,0,100.0,0.0,0,0,0
commons-math-3.6.1,org.apache.commons.math3.linear.QRDecomposition,7,7,0,7,0,100.0,0.0,78,78,0,78,0,0,100.0,0.0,67,66,98.51
commons-math-3.6.1,org.apache.commons.math3.linear.RRQRDecomposition$Solver,4,4,0,4,0,100.0,0.0,6,6,0,6,0,0,100.0,0.0,5,4,80.0
commons-math-3.6.1,org.apache.commons.math3.linear.OpenMapRealVector$OpenMapEntry,3,2,1,2,0,66.67,0.0,4,3,1,0,3,2,75.0,75.0,2,2,100.0
commons-math-3.6.1,org.apache.commons.math3.linear.PreconditionedIterativeLinearSolver,6,5,1,5,0,83.33,0.0,19,17,2,17,0,0,89.47,0.0,14,8,57.14
commons-math-3.6.1,org.apache.commons.math3.linear.SingularValueDecomposition$Solver,4,4,0,4,0,100.0,0.0,15,15,0,15,0,0,100.0,0.0,5,5,100.0
commons-math-3.6.1,org.apache.commons.math3.linear.MatrixUtils$FractionMatrixConverter,3,3,0,3,0,100.0,0.0,3,3,0,2,1,1,100.0,33.33,1,1,100.0
commons-math-3.6.1,org.apache.commons.math3.linear.FieldMatrixPreservingVisitor,0,0,0,0,0,0.0,0.0,0,0,0,0,0,0,0.0,0.0,0,0,0
commons-math-3.6.1,org.apache.commons.math3.linear.RealVector,101,95,6,91,4,94.06,3.96,246,240,6,228,12,8,97.56,4.88,155,130,83.87
commons-math-3.6.1,org.apache.commons.math3.linear.SparseRealMatrix,0,0,0,0,0,0.0,0.0,0,0,0,0,0,0,0.0,0.0,0,0,0
commons-math-3.6.1,org.apache.commons.math3.linear.SymmLQ$State,12,12,0,10,2,100.0,16.67,144,133,11,122,11,6,92.36,7.64,173,131,75.72
commons-math-3.6.1,org.apache.commons.math3.linear.FieldLUDecomposition$Solver,5,5,0,5,0,100.0,0.0,83,79,4,79,0,0,95.18,0.0,60,57,95.0
commons-math-3.6.1,org.apache.commons.math3.linear.NonSquareMatrixException,0,0,0,0,0,0.0,0.0,0,0,0,0,0,0,0.0,0.0,0,0,0
commons-math-3.6.1,org.apache.commons.math3.linear.SparseFieldMatrix,9,7,2,7,0,77.78,0.0,43,20,23,20,0,0,46.51,0.0,19,8,42.11
commons-math-3.6.1,org.apache.commons.math3.linear.BlockRealMatrix,51,50,1,50,0,98.04,0.0,565,536,29,536,0,0,94.87,0.0,882,755,85.6
commons-math-3.6.1,org.apache.commons.math3.linear.SingularOperatorException,0,0,0,0,0,0.0,0.0,0,0,0,0,0,0,0.0,0.0,0,0,0
commons-math-3.6.1,org.apache.commons.math3.linear.RealVectorPreservingVisitor,0,0,0,0,0,0.0,0.0,0,0,0,0,0,0,0.0,0.0,0,0,0
commons-math-3.6.1,org.apache.commons.math3.linear.OpenMapRealVector$OpenMapSparseIterator,3,2,1,1,1,66.67,33.33,6,5,1,1,4,2,83.33,66.67,4,3,75.0
commons-math-3.6.1,org.apache.commons.math3.linear.CholeskyDecomposition,4,4,0,4,0,100.0,0.0,41,41,0,41,0,0,100.0,0.0,10,10,100.0
commons-math-3.6.1,org.apache.commons.math3.linear.FieldDecompositionSolver,0,0,0,0,0,0.0,0.0,0,0,0,0,0,0,0.0,0.0,0,0,0
commons-math-3.6.1,org.apache.commons.math3.linear.BiDiagonalTransformer,9,6,3,6,0,66.67,0.0,162,159,3,159,0,0,98.15,0.0,191,180,94.24
commons-math-3.6.1,org.apache.commons.math3.linear.RealVector$Entry,4,4,0,4,0,100.0,0.0,5,5,0,5,0,0,100.0,0.0,3,3,100.0
commons-math-3.6.1,org.apache.commons.math3.linear.NonSelfAdjointOperatorException,0,0,0,0,0,0.0,0.0,0,0,0,0,0,0,0.0,0.0,0,0,0
commons-math-3.6.1,org.apache.commons.math3.linear.OpenMapRealMatrix,14,12,2,12,0,85.71,0.0,76,63,13,59,4,3,82.89,5.26,64,50,78.12
commons-math-3.6.1,org.apache.commons.math3.linear.NonPositiveDefiniteOperatorException,0,0,0,0,0,0.0,0.0,0,0,0,0,0,0,0.0,0.0,0,0,0
commons-math-3.6.1,org.apache.commons.math3.linear.ConjugateGradient,2,1,1,1,0,50.0,0.0,56,50,6,50,0,0,89.29,0.0,35,19,54.29
commons-math-3.6.1,org.apache.commons.math3.linear.CholeskyDecomposition$Solver,4,2,2,2,0,50.0,0.0,43,41,2,41,0,0,95.35,0.0,46,44,95.65
commons-math-3.6.1,org.apache.commons.math3.linear.LUDecomposition,6,6,0,6,0,100.0,0.0,90,90,0,90,0,0,100.0,0.0,31,30,96.77
commons-math-3.6.1,org.apache.commons.math3.linear.DecompositionSolver,0,0,0,0,0,0.0,0.0,0,0,0,0,0,0,0.0,0.0,0,0,0
commons-math-3.6.1,org.apache.commons.math3.linear.LUDecomposition$Solver,4,4,0,4,0,100.0,0.0,55,55,0,55,0,0,100.0,0.0,51,51,100.0
commons-math-3.6.1,org.apache.commons.math3.linear.ArrayFieldVector,53,53,0,49,4,100.0,7.55,326,279,47,273,6,3,85.58,1.84,190,125,65.79
commons-math-3.6.1,org.apache.commons.math3.linear.MatrixDimensionMismatchException,4,4,0,3,1,100.0,25.0,4,4,0,3,1,0,100.0,25.0,4,4,100.0
commons-math-3.6.1,org.apache.commons.math3.linear.ArrayRealVector,49,48,1,45,3,97.96,6.12,343,332,11,318,14,8,96.79,4.08,238,201,84.45
commons-math-3.6.1,org.apache.commons.math3.linear.RealVector$SparseEntryIterator,4,3,1,2,1,75.0,25.0,24,19,5,18,1,0,79.17,4.17,17,13,76.47
commons-math-3.6.1,org.apache.commons.math3.linear.IterativeLinearSolver,4,2,2,2,0,50.0,0.0,21,14,7,14,0,0,66.67,0.0,12,4,33.33
commons-math-3.6.1,org.apache.commons.math3.linear.FieldMatrix,0,0,0,0,0,0.0,0.0,0,0,0,0,0,0,0.0,0.0,0,0,0
commons-math-3.6.1,org.apache.commons.math3.linear.Array2DRowFieldMatrix,26,24,2,24,0,92.31,0.0,174,152,22,152,0,0,87.36,0.0,132,98,74.24
commons-math-3.6.1,org.apache.commons.math3.linear.BlockFieldMatrix,49,47,2,47,0,95.92,0.0,546,475,71,475,0,0,87.0,0.0,819,641,78.27
commons-math-3.6.1,org.apache.commons.math3.linear.Array2DRowRealMatrix,26,26,0,26,0,100.0,0.0,176,166,10,166,0,0,94.32,0.0,141,113,80.14
commons-math-3.6.1,org.apache.commons.math3.linear.AbstractRealMatrix,61,57,4,56,1,93.44,1.64,376,339,37,339,0,0,90.16,0.0,334,254,76.05
commons-math-3.6.1,org.apache.commons.math3.linear.DefaultRealMatrixChangingVisitor,2,1,1,0,1,50.0,50.0,2,1,1,1,0,0,50.0,0.0,1,0,0.0
commons-math-3.6.1,org.apache.commons.math3.linear.TriDiagonalTransformer,7,6,1,6,0,85.71,0.0,92,91,1,91,0,0,98.91,0.0,107,104,97.2
commons-math-3.6.1,org.apache.commons.math3.linear.FieldVectorChangingVisitor,0,0,0,0,0,0.0,0.0,0,0,0,0,0,0,0.0,0.0,0,0,0
commons-math-3.6.1,org.apache.commons.math3.linear.DefaultFieldMatrixPreservingVisitor,1,1,0,0,1,100.0,100.0,2,2,0,2,0,0,100.0,0.0,1,0,0.0
commons-math-3.6.1,org.apache.commons.math3.linear.EigenDecomposition$Solver,5,5,0,5,0,100.0,0.0,65,61,4,61,0,0,93.85,0.0,53,52,98.11
commons-math-3.6.1,org.apache.commons.math3.linear.SingularMatrixException,0,0,0,0,0,0.0,0.0,0,0,0,0,0,0,0.0,0.0,0,0,0
commons-math-3.6.1,org.apache.commons.math3.linear.RealMatrixPreservingVisitor,0,0,0,0,0,0.0,0.0,0,0,0,0,0,0,0.0,0.0,0,0,0
commons-math-3.6.1,org.apache.commons.math3.linear.SchurTransformer$ShiftInfo,0,0,0,0,0,0.0,0.0,0,0,0,0,0,0,0.0,0.0,0,0,0
commons-math-3.6.1,org.apache.commons.math3.linear.OpenMapRealVector,36,33,3,33,0,91.67,0.0,301,279,22,278,1,1,92.69,0.33,201,157,78.11
commons-math-3.6.1,org.apache.commons.math3.linear.MatrixUtils,36,34,2,34,0,94.44,0.0,241,183,58,181,2,1,75.93,0.83,192,157,81.77
commons-math-3.6.1,org.apache.commons.math3.linear.RealMatrixFormat,14,7,7,6,1,50.0,7.14,101,88,13,88,0,0,87.13,0.0,52,39,75.0
commons-math-3.6.1,org.apache.commons.math3.linear.NonPositiveDefiniteMatrixException,3,0,3,0,0,0.0,0.0,7,4,3,4,0,0,57.14,0.0,3,0,0.0
commons-math-3.6.1,org.apache.commons.math3.linear.FieldLUDecomposition,6,6,0,6,0,100.0,0.0,90,90,0,90,0,0,100.0,0.0,31,30,96.77
commons-math-3.6.1,org.apache.commons.math3.linear.RealMatrixChangingVisitor,0,0,0,0,0,0.0,0.0,0,0,0,0,0,0,0.0,0.0,0,0,0
commons-math-3.6.1,org.apache.commons.math3.linear.EigenDecomposition,17,15,2,14,1,88.24,5.88,335,307,28,307,0,0,91.64,0.0,376,304,80.85
commons-math-3.6.1,org.apache.commons.math3.linear.SingularValueDecomposition,13,12,1,12,0,92.31,0.0,309,304,5,304,0,0,98.38,0.0,32,28,87.5
commons-math-3.6.1,org.apache.commons.math3.linear.NonSquareOperatorException,0,0,0,0,0,0.0,0.0,0,0,0,0,0,0,0.0,0.0,0,0,0
commons-math-3.6.1,org.apache.commons.math3.linear.AnyMatrix,0,0,0,0,0,0.0,0.0,0,0,0,0,0,0,0.0,0.0,0,0,0
commons-math-3.6.1,org.apache.commons.math3.linear.FieldVector,0,0,0,0,0,0.0,0.0,0,0,0,0,0,0,0.0,0.0,0,0,0
commons-math-3.6.1,org.apache.commons.math3.linear.FieldVectorPreservingVisitor,0,0,0,0,0,0.0,0.0,0,0,0,0,0,0,0.0,0.0,0,0,0
commons-math-3.6.1,org.apache.commons.math3.linear.QRDecomposition$Solver,4,4,0,4,0,100.0,0.0,71,71,0,71,0,0,100.0,0.0,82,79,96.34
commons-math-3.6.1,org.apache.commons.math3.linear.NonSymmetricMatrixException,3,0,3,0,0,0.0,0.0,6,3,3,3,0,0,50.0,0.0,3,0,0.0
commons-math-3.6.1,org.apache.commons.math3.distribution.LevyDistribution,13,11,2,8,3,84.62,23.08,28,20,8,17,3,1,71.43,10.71,43,34,79.07
commons-math-3.6.1,org.apache.commons.math3.distribution.LogisticDistribution,12,10,2,7,3,83.33,25.0,29,21,8,21,0,0,72.41,0.0,41,32,78.05
commons-math-3.6.1,org.apache.commons.math3.distribution.EnumeratedRealDistribution,13,13,0,10,3,100.0,23.08,69,67,2,67,0,0,97.1,0.0,44,41,93.18
commons-math-3.6.1,org.apache.commons.math3.distribution.GammaDistribution,16,15,1,10,5,93.75,31.25,72,65,7,65,0,0,90.28,0.0,120,73,60.83
commons-math-3.6.1,org.apache.commons.math3.distribution.MixtureMultivariateRealDistribution,4,4,0,3,1,100.0,25.0,45,41,4,41,0,0,91.11,0.0,22,19,86.36
commons-math-3.6.1,org.apache.commons.math3.distribution.KolmogorovSmirnovDistribution,6,3,3,3,0,50.0,0.0,80,62,18,62,0,0,77.5,0.0,91,60,65.93
commons-math-3.6.1,org.apache.commons.math3.distribution.PoissonDistribution,12,11,1,10,1,91.67,8.33,90,43,47,43,0,0,47.78,0.0,132,96,72.73
commons-math-3.6.1,org.apache.commons.math3.distribution.AbstractIntegerDistribution,8,8,0,8,0,100.0,0.0,66,57,9,57,0,0,86.36,0.0,63,36,57.14
commons-math-3.6.1,org.apache.commons.math3.distribution.AbstractMultivariateRealDistribution,3,3,0,3,0,100.0,0.0,11,9,2,9,0,0,81.82,0.0,7,6,85.71
commons-math-3.6.1,org.apache.commons.math3.distribution.GeometricDistribution,10,8,2,7,1,80.0,10.0,34,30,4,30,0,0,88.24,0.0,38,36,94.74
commons-math-3.6.1,org.apache.commons.math3.distribution.FDistribution,14,14,0,9,5,100.0,35.71,39,39,0,39,0,0,100.0,0.0,56,51,91.07
commons-math-3.6.1,org.apache.commons.math3.distribution.BetaDistribution$ChengBetaSampler,3,3,0,3,0,100.0,0.0,36,36,0,36,0,0,100.0,0.0,88,67,76.14
commons-math-3.6.1,org.apache.commons.math3.distribution.ParetoDistribution,15,15,0,11,4,100.0,26.67,40,38,2,38,0,0,95.0,0.0,50,44,88.0
commons-math-3.6.1,org.apache.commons.math3.distribution.PascalDistribution,10,9,1,8,1,90.0,10.0,32,27,5,27,0,0,84.38,0.0,36,35,97.22
commons-math-3.6.1,org.apache.commons.math3.distribution.LogNormalDistribution,16,16,0,11,5,100.0,31.25,42,42,0,42,0,0,100.0,0.0,68,57,83.82
commons-math-3.6.1,org.apache.commons.math3.distribution.UniformIntegerDistribution,8,7,1,7,0,87.5,0.0,30,29,1,29,0,0,96.67,0.0,42,35,83.33
commons-math-3.6.1,org.apache.commons.math3.distribution.ExponentialDistribution,14,12,2,9,3,85.71,21.43,62,60,2,60,0,0,96.77,0.0,53,44,83.02
commons-math-3.6.1,org.apache.commons.math3.distribution.MultivariateNormalDistribution,6,5,1,5,0,83.33,0.0,51,39,12,39,0,0,76.47,0.0,25,22,88.0
commons-math-3.6.1,org.apache.commons.math3.distribution.ConstantRealDistribution,11,10,1,4,6,90.91,54.55,15,14,1,8,6,0,93.33,40.0,16,12,75.0
commons-math-3.6.1,org.apache.commons.math3.distribution.EnumeratedDistribution,6,4,2,4,0,66.67,0.0,63,45,18,45,0,0,71.43,0.0,38,20,52.63
commons-math-3.6.1,org.apache.commons.math3.distribution.NakagamiDistribution,12,12,0,4,8,100.0,66.67,25,21,4,21,0,0,84.0,0.0,38,22,57.89
commons-math-3.6.1,org.apache.commons.math3.distribution.MultivariateRealDistribution,0,0,0,0,0,0.0,0.0,0,0,0,0,0,0,0.0,0.0,0,0,0
commons-math-3.6.1,org.apache.commons.math3.distribution.WeibullDistribution,16,14,2,11,3,87.5,18.75,53,45,8,45,0,0,84.91,0.0,60,54,90.0
commons-math-3.6.1,org.apache.commons.math3.distribution.IntegerDistribution,0,0,0,0,0,0.0,0.0,0,0,0,0,0,0,0.0,0.0,0,0,0
commons-math-3.6.1,org.apache.commons.math3.distribution.EnumeratedIntegerDistribution,9,9,0,8,1,100.0,11.11,51,51,0,51,0,0,100.0,0.0,32,29,90.62
commons-math-3.6.1,org.apache.commons.math3.distribution.BinomialDistribution,10,9,1,9,0,90.0,0.0,32,27,5,27,0,0,84.38,0.0,33,32,96.97
commons-math-3.6.1,org.apache.commons.math3.distribution.ZipfDistribution$ZipfRejectionInversionSampler,6,6,0,5,1,100.0,16.67,33,27,6,27,0,0,81.82,0.0,53,29,54.72
commons-math-3.6.1,org.apache.commons.math3.distribution.ZipfDistribution,14,13,1,12,1,92.86,7.14,49,48,1,48,0,0,97.96,0.0,50,46,92.0
commons-math-3.6.1,org.apache.commons.math3.distribution.GumbelDistribution,12,10,2,7,3,83.33,25.0,26,18,8,18,0,0,69.23,0.0,37,27,72.97
commons-math-3.6.1,org.apache.commons.math3.distribution.UniformRealDistribution,11,10,1,8,2,90.91,18.18,29,28,1,28,0,0,96.55,0.0,41,38,92.68
commons-math-3.6.1,org.apache.commons.math3.distribution.MixtureMultivariateNormalDistribution,1,1,0,1,0,100.0,0.0,4,4,0,4,0,0,100.0,0.0,3,3,100.0
commons-math-3.6.1,org.apache.commons.math3.distribution.SaddlePointExpansion,3,3,0,3,0,100.0,0.0,44,43,1,43,0,0,97.73,0.0,76,51,67.11
commons-math-3.6.1,org.apache.commons.math3.distribution.NormalDistribution,17,15,2,13,2,88.24,11.76,33,31,2,31,0,0,93.94,0.0,53,49,92.45
commons-math-3.6.1,org.apache.commons.math3.distribution.RealDistribution,0,0,0,0,0,0.0,0.0,0,0,0,0,0,0,0.0,0.0,0,0,0
commons-math-3.6.1,org.apache.commons.math3.distribution.BetaDistribution,15,13,2,10,3,86.67,20.0,45,31,14,31,0,0,68.89,0.0,52,38,73.08
commons-math-3.6.1,org.apache.commons.math3.distribution.TriangularDistribution,12,9,3,7,2,75.0,16.67,69,66,3,66,0,0,95.65,0.0,111,98,88.29
commons-math-3.6.1,org.apache.commons.math3.distribution.ChiSquaredDistribution,12,12,0,7,5,100.0,41.67,14,14,0,14,0,0,100.0,0.0,13,11,84.62
commons-math-3.6.1,org.apache.commons.math3.distribution.TDistribution,12,12,0,8,4,100.0,33.33,35,35,0,35,0,0,100.0,0.0,41,36,87.8
commons-math-3.6.1,org.apache.commons.math3.distribution.HypergeometricDistribution,17,16,1,16,0,94.12,0.0,69,66,3,66,0,0,95.65,0.0,56,53,94.64
commons-math-3.6.1,org.apache.commons.math3.distribution.AbstractRealDistribution,10,9,1,8,1,90.0,10.0,69,65,4,65,0,0,94.2,0.0,60,43,71.67
commons-math-3.6.1,org.apache.commons.math3.distribution.LaplaceDistribution,12,10,2,5,5,83.33,41.67,30,22,8,22,0,0,73.33,0.0,45,28,62.22
commons-math-3.6.1,org.apache.commons.math3.distribution.CauchyDistribution,13,11,2,9,2,84.62,15.38,29,27,2,27,0,0,93.1,0.0,33,30,90.91
commons-math-3.6.1,org.apache.commons.math3.distribution.fitting.MultivariateNormalMixtureExpectationMaximization,5,5,0,5,0,100.0,0.0,94,88,6,88,0,0,93.62,0.0,75,66,88.0
commons-math-3.6.1,org.apache.commons.math3.distribution.fitting.MultivariateNormalMixtureExpectationMaximization$DataRow,4,2,2,2,0,50.0,0.0,16,8,8,8,0,0,50.0,0.0,9,2,22.22
commons-math-3.6.1,org.apache.commons.math3.optim.OptimizationData,0,0,0,0,0,0.0,0.0,0,0,0,0,0,0,0.0,0.0,0,0,0
commons-math-3.6.1,org.apache.commons.math3.optim.PointValuePair$DataTransferObject,1,1,0,1,0,100.0,0.0,3,3,0,3,0,0,100.0,0.0,1,1,100.0
commons-math-3.6.1,org.apache.commons.math3.optim.MaxEval,2,1,1,1,0,50.0,0.0,6,3,3,3,0,0,50.0,0.0,2,1,50.0
commons-math-3.6.1,org.apache.commons.math3.optim.OptimizationProblem,0,0,0,0,0,0.0,0.0,0,0,0,0,0,0,0.0,0.0,0,0,0
commons-math-3.6.1,org.apache.commons.math3.optim.ConvergenceChecker,0,0,0,0,0,0.0,0.0,0,0,0,0,0,0,0.0,0.0,0,0,0
commons-math-3.6.1,org.apache.commons.math3.optim.BaseMultivariateOptimizer,6,6,0,6,0,100.0,0.0,38,36,2,36,0,0,94.74,0.0,24,23,95.83
commons-math-3.6.1,org.apache.commons.math3.optim.BaseOptimizer$MaxIterCallback,1,1,0,1,0,100.0,0.0,1,1,0,1,0,0,100.0,0.0,0,0,0
commons-math-3.6.1,org.apache.commons.math3.optim.BaseOptimizer,10,8,2,8,0,80.0,0.0,26,22,4,22,0,0,84.62,0.0,18,14,77.78
commons-math-3.6.1,org.apache.commons.math3.optim.BaseMultiStartMultivariateOptimizer,3,3,0,3,0,100.0,0.0,57,51,6,51,0,0,89.47,0.0,31,23,74.19
commons-math-3.6.1,org.apache.commons.math3.optim.SimpleVectorValueChecker,1,1,0,1,0,100.0,0.0,14,14,0,14,0,0,100.0,0.0,14,12,85.71
commons-math-3.6.1,org.apache.commons.math3.optim.AbstractOptimizationProblem$MaxEvalCallback,1,1,0,1,0,100.0,0.0,1,1,0,1,0,0,100.0,0.0,0,0,0
commons-math-3.6.1,org.apache.commons.math3.optim.SimplePointChecker,1,1,0,1,0,100.0,0.0,14,14,0,14,0,0,100.0,0.0,14,12,85.71
commons-math-3.6.1,org.apache.commons.math3.optim.AbstractOptimizationProblem$MaxIterCallback,1,1,0,1,0,100.0,0.0,1,1,0,1,0,0,100.0,0.0,0,0,0
commons-math-3.6.1,org.apache.commons.math3.optim.BaseOptimizer$MaxEvalCallback,1,1,0,1,0,100.0,0.0,1,1,0,1,0,0,100.0,0.0,0,0,0
commons-math-3.6.1,org.apache.commons.math3.optim.PointVectorValuePair,5,5,0,5,0,100.0,0.0,5,5,0,5,0,0,100.0,0.0,7,7,100.0
commons-math-3.6.1,org.apache.commons.math3.optim.SimpleBounds,3,3,0,3,0,100.0,0.0,7,7,0,7,0,0,100.0,0.0,5,5,100.0
commons-math-3.6.1,org.apache.commons.math3.optim.AbstractOptimizationProblem,3,3,0,3,0,100.0,0.0,6,6,0,6,0,0,100.0,0.0,3,3,100.0
commons-math-3.6.1,org.apache.commons.math3.optim.MaxIter,2,1,1,1,0,50.0,0.0,6,3,3,3,0,0,50.0,0.0,2,1,50.0
commons-math-3.6.1,org.apache.commons.math3.optim.InitialGuess,1,1,0,1,0,100.0,0.0,2,2,0,2,0,0,100.0,0.0,1,1,100.0
commons-math-3.6.1,org.apache.commons.math3.optim.AbstractConvergenceChecker,2,2,0,2,0,100.0,0.0,4,4,0,4,0,0,100.0,0.0,2,2,100.0
commons-math-3.6.1,org.apache.commons.math3.optim.SimpleValueChecker,1,1,0,1,0,100.0,0.0,9,9,0,9,0,0,100.0,0.0,11,9,81.82
commons-math-3.6.1,org.apache.commons.math3.optim.PointValuePair,3,3,0,3,0,100.0,0.0,3,3,0,3,0,0,100.0,0.0,4,4,100.0
commons-math-3.6.1,org.apache.commons.math3.optim.PointVectorValuePair$DataTransferObject,1,1,0,1,0,100.0,0.0,3,3,0,3,0,0,100.0,0.0,1,1,100.0
commons-math-3.6.1,org.apache.commons.math3.optim.linear.Relationship,2,1,1,1,0,50.0,0.0,6,5,1,5,0,0,83.33,0.0,4,2,50.0
commons-math-3.6.1,org.apache.commons.math3.optim.linear.NonNegativeConstraint,1,1,0,1,0,100.0,0.0,2,2,0,2,0,0,100.0,0.0,2,2,100.0
commons-math-3.6.1,org.apache.commons.math3.optim.linear.LinearObjectiveFunction,8,7,1,5,2,87.5,25.0,19,15,4,15,0,0,78.95,0.0,18,11,61.11
commons-math-3.6.1,org.apache.commons.math3.optim.linear.SolutionCallback,3,3,0,2,1,100.0,33.33,3,3,0,3,0,0,100.0,0.0,3,3,100.0
commons-math-3.6.1,org.apache.commons.math3.optim.linear.SimplexTableau,35,32,3,31,1,91.43,2.86,206,200,6,200,0,0,97.09,0.0,185,159,85.95
commons-math-3.6.1,org.apache.commons.math3.optim.linear.UnboundedSolutionException,0,0,0,0,0,0.0,0.0,0,0,0,0,0,0,0.0,0.0,0,0,0
commons-math-3.6.1,org.apache.commons.math3.optim.linear.LinearOptimizer,5,5,0,5,0,100.0,0.0,18,18,0,18,0,0,100.0,0.0,9,9,100.0
commons-math-3.6.1,org.apache.commons.math3.optim.linear.SimplexSolver,8,8,0,7,1,100.0,12.5,106,103,3,103,0,0,97.17,0.0,65,43,66.15
commons-math-3.6.1,org.apache.commons.math3.optim.linear.PivotSelectionRule,0,0,0,0,0,0.0,0.0,0,0,0,0,0,0,0.0,0.0,0,0,0
commons-math-3.6.1,org.apache.commons.math3.optim.linear.LinearConstraint,7,7,0,6,1,100.0,14.29,29,16,13,16,0,0,55.17,0.0,18,13,72.22
commons-math-3.6.1,org.apache.commons.math3.optim.linear.LinearConstraintSet,1,1,0,1,0,100.0,0.0,4,2,2,2,0,0,50.0,0.0,1,1,100.0
commons-math-3.6.1,org.apache.commons.math3.optim.linear.NoFeasibleSolutionException,0,0,0,0,0,0.0,0.0,0,0,0,0,0,0,0.0,0.0,0,0,0
commons-math-3.6.1,org.apache.commons.math3.optim.univariate.UnivariateOptimizer,7,7,0,7,0,100.0,0.0,23,23,0,23,0,0,100.0,0.0,11,11,100.0
commons-math-3.6.1,org.apache.commons.math3.optim.univariate.BracketFinder,10,5,5,5,0,50.0,0.0,95,85,10,85,0,0,89.47,0.0,85,50,58.82
commons-math-3.6.1,org.apache.commons.math3.optim.univariate.UnivariatePointValuePair,2,2,0,2,0,100.0,0.0,4,4,0,4,0,0,100.0,0.0,2,2,100.0
commons-math-3.6.1,org.apache.commons.math3.optim.univariate.SearchInterval,3,3,0,3,0,100.0,0.0,12,8,4,8,0,0,66.67,0.0,3,3,100.0
commons-math-3.6.1,org.apache.commons.math3.optim.univariate.SimpleUnivariateValueChecker,1,1,0,1,0,100.0,0.0,9,9,0,9,0,0,100.0,0.0,11,9,81.82
commons-math-3.6.1,org.apache.commons.math3.optim.univariate.UnivariateObjectiveFunction,1,1,0,1,0,100.0,0.0,2,2,0,2,0,0,100.0,0.0,1,1,100.0
commons-math-3.6.1,org.apache.commons.math3.optim.univariate.BrentOptimizer,2,2,0,2,0,100.0,0.0,123,113,10,113,0,0,91.87,0.0,111,93,83.78
commons-math-3.6.1,org.apache.commons.math3.optim.univariate.MultiStartUnivariateOptimizer,6,6,0,6,0,100.0,0.0,56,50,6,50,0,0,89.29,0.0,22,21,95.45
commons-math-3.6.1,org.apache.commons.math3.optim.nonlinear.scalar.MultivariateFunctionMappingAdapter$Mapper,0,0,0,0,0,0.0,0.0,0,0,0,0,0,0,0.0,0.0,0,0,0
commons-math-3.6.1,org.apache.commons.math3.optim.nonlinear.scalar.ObjectiveFunctionGradient,1,1,0,1,0,100.0,0.0,2,2,0,2,0,0,100.0,0.0,1,1,100.0
commons-math-3.6.1,org.apache.commons.math3.optim.nonlinear.scalar.MultivariateFunctionMappingAdapter$LowerUpperBoundMapper,2,2,0,2,0,100.0,0.0,4,4,0,4,0,0,100.0,0.0,2,2,100.0
commons-math-3.6.1,org.apache.commons.math3.optim.nonlinear.scalar.MultivariateFunctionPenaltyAdapter,1,1,0,1,0,100.0,0.0,36,30,6,30,0,0,83.33,0.0,20,16,80.0
commons-math-3.6.1,org.apache.commons.math3.optim.nonlinear.scalar.MultiStartMultivariateOptimizer,5,5,0,4,1,100.0,20.0,13,9,4,9,0,0,69.23,0.0,4,3,75.0
commons-math-3.6.1,org.apache.commons.math3.optim.nonlinear.scalar.GoalType,0,0,0,0,0,0.0,0.0,0,0,0,0,0,0,0.0,0.0,0,0,0
commons-math-3.6.1,org.apache.commons.math3.optim.nonlinear.scalar.MultivariateOptimizer,4,4,0,4,0,100.0,0.0,14,14,0,14,0,0,100.0,0.0,7,7,100.0
commons-math-3.6.1,org.apache.commons.math3.optim.nonlinear.scalar.MultivariateFunctionMappingAdapter$NoBoundsMapper,2,2,0,2,0,100.0,0.0,2,2,0,2,0,0,100.0,0.0,2,2,100.0
commons-math-3.6.1,org.apache.commons.math3.optim.nonlinear.scalar.ObjectiveFunction,1,1,0,1,0,100.0,0.0,2,2,0,2,0,0,100.0,0.0,1,1,100.0
commons-math-3.6.1,org.apache.commons.math3.optim.nonlinear.scalar.LineSearch,2,2,0,2,0,100.0,0.0,9,9,0,9,0,0,100.0,0.0,2,2,100.0
commons-math-3.6.1,org.apache.commons.math3.optim.nonlinear.scalar.MultivariateFunctionMappingAdapter,3,3,0,3,0,100.0,0.0,33,29,4,29,0,0,87.88,0.0,7,7,100.0
commons-math-3.6.1,org.apache.commons.math3.optim.nonlinear.scalar.MultivariateFunctionMappingAdapter$UpperBoundMapper,2,2,0,2,0,100.0,0.0,3,3,0,3,0,0,100.0,0.0,6,5,83.33
commons-math-3.6.1,org.apache.commons.math3.optim.nonlinear.scalar.MultivariateFunctionMappingAdapter$LowerBoundMapper,2,2,0,2,0,100.0,0.0,3,3,0,3,0,0,100.0,0.0,4,3,75.0
commons-math-3.6.1,org.apache.commons.math3.optim.nonlinear.scalar.GradientMultivariateOptimizer,3,3,0,3,0,100.0,0.0,8,8,0,8,0,0,100.0,0.0,4,4,100.0
commons-math-3.6.1,org.apache.commons.math3.optim.nonlinear.scalar.LeastSquaresConverter,1,1,0,1,0,100.0,0.0,37,31,6,31,0,0,83.78,0.0,16,16,100.0
commons-math-3.6.1,org.apache.commons.math3.optim.nonlinear.scalar.gradient.NonLinearConjugateGradientOptimizer$IdentityPreconditioner,1,1,0,1,0,100.0,0.0,1,1,0,1,0,0,100.0,0.0,1,1,100.0
commons-math-3.6.1,org.apache.commons.math3.optim.nonlinear.scalar.gradient.NonLinearConjugateGradientOptimizer$Formula,0,0,0,0,0,0.0,0.0,0,0,0,0,0,0,0.0,0.0,0,0,0
commons-math-3.6.1,org.apache.commons.math3.optim.nonlinear.scalar.gradient.NonLinearConjugateGradientOptimizer$BracketingStep,1,0,1,0,0,0.0,0.0,2,0,2,0,0,0,0.0,0.0,1,0,0.0
commons-math-3.6.1,org.apache.commons.math3.optim.nonlinear.scalar.gradient.NonLinearConjugateGradientOptimizer,4,4,0,4,0,100.0,0.0,60,57,3,57,0,0,95.0,0.0,44,42,95.45
commons-math-3.6.1,org.apache.commons.math3.optim.nonlinear.scalar.gradient.Preconditioner,0,0,0,0,0,0.0,0.0,0,0,0,0,0,0,0.0,0.0,0,0,0
commons-math-3.6.1,org.apache.commons.math3.optim.nonlinear.scalar.noderiv.MultiDirectionalSimplex,2,2,0,2,0,100.0,0.0,22,22,0,22,0,0,100.0,0.0,16,14,87.5
commons-math-3.6.1,org.apache.commons.math3.optim.nonlinear.scalar.noderiv.CMAESOptimizer$FitnessFunction,4,3,1,2,1,75.0,25.0,36,26,10,26,0,0,72.22,0.0,29,12,41.38
commons-math-3.6.1,org.apache.commons.math3.optim.nonlinear.scalar.noderiv.PowellOptimizer,3,3,0,3,0,100.0,0.0,74,68,6,68,0,0,91.89,0.0,56,28,50.0
commons-math-3.6.1,org.apache.commons.math3.optim.nonlinear.scalar.noderiv.BOBYQAOptimizer$PathIsExploredException,0,0,0,0,0,0.0,0.0,0,0,0,0,0,0,0.0,0.0,0,0,0
commons-math-3.6.1,org.apache.commons.math3.optim.nonlinear.scalar.noderiv.CMAESOptimizer$PopulationSize,1,1,0,1,0,100.0,0.0,5,3,2,3,0,0,60.0,0.0,1,1,100.0
commons-math-3.6.1,org.apache.commons.math3.optim.nonlinear.scalar.noderiv.CMAESOptimizer,39,34,5,29,5,87.18,12.82,389,349,40,349,0,0,89.72,0.0,411,237,57.66
commons-math-3.6.1,org.apache.commons.math3.optim.nonlinear.scalar.noderiv.CMAESOptimizer$DoubleIndex,3,1,2,1,0,33.33,0.0,12,3,9,3,0,0,25.0,0.0,12,1,8.33
commons-math-3.6.1,org.apache.commons.math3.optim.nonlinear.scalar.noderiv.CMAESOptimizer$Sigma,1,1,0,1,0,100.0,0.0,7,7,0,7,0,0,100.0,0.0,1,1,100.0
commons-math-3.6.1,org.apache.commons.math3.optim.nonlinear.scalar.noderiv.CMAESOptimizer$ValuePenaltyPair,0,0,0,0,0,0.0,0.0,2,2,0,2,0,0,100.0,0.0,0,0,0
commons-math-3.6.1,org.apache.commons.math3.optim.nonlinear.scalar.noderiv.NelderMeadSimplex,1,1,0,1,0,100.0,0.0,58,58,0,58,0,0,100.0,0.0,58,53,91.38
commons-math-3.6.1,org.apache.commons.math3.optim.nonlinear.scalar.noderiv.BOBYQAOptimizer,9,8,1,8,0,88.89,0.0,1286,1086,200,1086,0,0,84.45,0.0,1440,904,62.78
commons-math-3.6.1,org.apache.commons.math3.optim.nonlinear.scalar.noderiv.SimplexOptimizer,6,6,0,6,0,100.0,0.0,35,33,2,33,0,0,94.29,0.0,20,20,100.0
commons-math-3.6.1,org.apache.commons.math3.optim.nonlinear.scalar.noderiv.AbstractSimplex,10,10,0,10,0,100.0,0.0,88,68,20,68,0,0,77.27,0.0,35,29,82.86
commons-math-3.6.1,org.apache.commons.math3.optim.nonlinear.vector.MultiStartMultivariateVectorOptimizer,6,6,0,3,3,100.0,50.0,14,10,4,10,0,0,71.43,0.0,4,2,50.0
commons-math-3.6.1,org.apache.commons.math3.optim.nonlinear.vector.Weight,1,1,0,1,0,100.0,0.0,6,2,4,2,0,0,33.33,0.0,1,1,100.0
commons-math-3.6.1,org.apache.commons.math3.optim.nonlinear.vector.Target,1,1,0,1,0,100.0,0.0,2,2,0,2,0,0,100.0,0.0,1,1,100.0
commons-math-3.6.1,org.apache.commons.math3.optim.nonlinear.vector.MultivariateVectorOptimizer,7,7,0,7,0,100.0,0.0,24,24,0,24,0,0,100.0,0.0,12,11,91.67
commons-math-3.6.1,org.apache.commons.math3.optim.nonlinear.vector.JacobianMultivariateVectorOptimizer,3,3,0,3,0,100.0,0.0,8,8,0,8,0,0,100.0,0.0,4,4,100.0
commons-math-3.6.1,org.apache.commons.math3.optim.nonlinear.vector.ModelFunctionJacobian,1,1,0,1,0,100.0,0.0,2,2,0,2,0,0,100.0,0.0,1,1,100.0
commons-math-3.6.1,org.apache.commons.math3.optim.nonlinear.vector.ModelFunction,1,1,0,1,0,100.0,0.0,2,2,0,2,0,0,100.0,0.0,1,1,100.0
commons-math-3.6.1,org.apache.commons.math3.optim.nonlinear.vector.jacobian.GaussNewtonOptimizer,2,2,0,2,0,100.0,0.0,44,41,3,41,0,0,93.18,0.0,30,30,100.0
commons-math-3.6.1,org.apache.commons.math3.optim.nonlinear.vector.jacobian.AbstractLeastSquaresOptimizer,12,12,0,12,0,100.0,0.0,32,31,1,31,0,0,96.88,0.0,25,23,92.0
commons-math-3.6.1,org.apache.commons.math3.optim.nonlinear.vector.jacobian.LevenbergMarquardtOptimizer,6,6,0,6,0,100.0,0.0,424,407,17,407,0,0,95.99,0.0,346,297,85.84
commons-math-3.6.1,org.apache.commons.math3.special.BesselJ$BesselJResult,2,0,2,0,0,0.0,0.0,4,2,2,2,0,0,50.0,0.0,2,0,0.0
commons-math-3.6.1,org.apache.commons.math3.special.Beta,12,9,3,8,1,75.0,8.33,128,119,9,119,0,0,92.97,0.0,230,195,84.78
commons-math-3.6.1,org.apache.commons.math3.special.Gamma,13,13,0,13,0,100.0,0.0,188,182,6,182,0,0,96.81,0.0,314,266,84.71
commons-math-3.6.1,org.apache.commons.math3.special.BesselJ,3,2,1,2,0,66.67,0.0,292,277,15,277,0,0,94.86,0.0,355,230,64.79
commons-math-3.6.1,org.apache.commons.math3.special.Erf,5,5,0,5,0,100.0,0.0,84,84,0,84,0,0,100.0,0.0,167,143,85.63
commons-math-3.6.1,org.apache.commons.math3.ode.MultistepFieldIntegrator$InitializationCompletedMarkerException,0,0,0,0,0,0.0,0.0,0,0,0,0,0,0,0.0,0.0,0,0,0
commons-math-3.6.1,org.apache.commons.math3.ode.MultistepIntegrator$NordsieckTransformer,0,0,0,0,0,0.0,0.0,0,0,0,0,0,0,0.0,0.0,0,0,0
commons-math-3.6.1,org.apache.commons.math3.ode.FirstOrderIntegrator,0,0,0,0,0,0.0,0.0,0,0,0,0,0,0,0.0,0.0,0,0,0
commons-math-3.6.1,org.apache.commons.math3.ode.ParameterizedODE,0,0,0,0,0,0.0,0.0,0,0,0,0,0,0,0.0,0.0,0,0,0
commons-math-3.6.1,org.apache.commons.math3.ode.EquationsMapper,4,4,0,4,0,100.0,0.0,12,8,4,8,0,0,66.67,0.0,6,6,100.0
commons-math-3.6.1,org.apache.commons.math3.ode.FirstOrderDifferentialEquations,0,0,0,0,0,0.0,0.0,0,0,0,0,0,0,0.0,0.0,0,0,0
commons-math-3.6.1,org.apache.commons.math3.ode.ContinuousOutputModel,12,10,2,7,3,83.33,25.0,103,99,4,99,0,0,96.12,0.0,106,40,37.74
commons-math-3.6.1,org.apache.commons.math3.ode.UnknownParameterException,1,1,0,1,0,100.0,0.0,2,2,0,2,0,0,100.0,0.0,1,1,100.0
commons-math-3.6.1,org.apache.commons.math3.ode.MultistepIntegrator$InitializationCompletedMarkerException,0,0,0,0,0,0.0,0.0,0,0,0,0,0,0,0.0,0.0,0,0,0
commons-math-3.6.1,org.apache.commons.math3.ode.AbstractParameterizable,3,2,1,2,0,66.67,0.0,14,11,3,11,0,0,78.57,0.0,5,4,80.0
commons-math-3.6.1,org.apache.commons.math3.ode.MultistepIntegrator$NordsieckInitializer,1,1,0,1,0,100.0,0.0,35,29,6,29,0,0,82.86,0.0,23,15,65.22
commons-math-3.6.1,org.apache.commons.math3.ode.SecondOrderDifferentialEquations,0,0,0,0,0,0.0,0.0,0,0,0,0,0,0,0.0,0.0,0,0,0
commons-math-3.6.1,org.apache.commons.math3.ode.AbstractIntegrator,24,22,2,20,2,91.67,8.33,109,107,2,107,0,0,98.17,0.0,70,54,77.14
commons-math-3.6.1,org.apache.commons.math3.ode.ExpandableStatefulODE$SecondaryComponent,0,0,0,0,0,0.0,0.0,4,4,0,4,0,0,100.0,0.0,0,0,0
commons-math-3.6.1,org.apache.commons.math3.ode.ParameterizedWrapper,5,0,5,0,0,0.0,0.0,9,0,9,0,0,0,0.0,0.0,6,0,0.0
commons-math-3.6.1,org.apache.commons.math3.ode.JacobianMatrices$MismatchedEquations,0,0,0,0,0,0.0,0.0,0,0,0,0,0,0,0.0,0.0,0,0,0
commons-math-3.6.1,org.apache.commons.math3.ode.FieldExpandableODE,4,4,0,3,1,100.0,25.0,18,18,0,18,0,0,100.0,0.0,15,14,93.33
commons-math-3.6.1,org.apache.commons.math3.ode.FieldEquationsMapper,8,8,0,8,0,100.0,0.0,52,52,0,52,0,0,100.0,0.0,49,46,93.88
commons-math-3.6.1,org.apache.commons.math3.ode.MultistepFieldIntegrator$FieldNordsieckInitializer,1,1,0,1,0,100.0,0.0,25,25,0,25,0,0,100.0,0.0,10,8,80.0
commons-math-3.6.1,org.apache.commons.math3.ode.ParameterJacobianWrapper,3,2,1,1,1,66.67,33.33,18,16,2,16,0,0,88.89,0.0,13,10,76.92
commons-math-3.6.1,org.apache.commons.math3.ode.FirstOrderFieldIntegrator,0,0,0,0,0,0.0,0.0,0,0,0,0,0,0,0.0,0.0,0,0,0
commons-math-3.6.1,org.apache.commons.math3.ode.SecondaryEquations,0,0,0,0,0,0.0,0.0,0,0,0,0,0,0,0.0,0.0,0,0,0
commons-math-3.6.1,org.apache.commons.math3.ode.MainStateJacobianProvider,0,0,0,0,0,0.0,0.0,0,0,0,0,0,0,0.0,0.0,0,0,0
commons-math-3.6.1,org.apache.commons.math3.ode.FieldSecondaryEquations,0,0,0,0,0,0.0,0.0,0,0,0,0,0,0,0.0,0.0,0,0,0
commons-math-3.6.1,org.apache.commons.math3.ode.JacobianMatrices,9,9,0,7,2,100.0,22.22,75,62,13,62,0,0,82.67,0.0,28,22,78.57
commons-math-3.6.1,org.apache.commons.math3.ode.Parameterizable,0,0,0,0,0,0.0,0.0,0,0,0,0,0,0,0.0,0.0,0,0,0
commons-math-3.6.1,org.apache.commons.math3.ode.JacobianMatrices$JacobiansSecondaryEquations,2,2,0,2,0,100.0,0.0,43,41,2,41,0,0,95.35,0.0,37,32,86.49
commons-math-3.6.1,org.apache.commons.math3.ode.MultistepIntegrator,13,7,6,5,2,53.85,15.38,38,29,9,29,0,0,76.32,0.0,16,7,43.75
commons-math-3.6.1,org.apache.commons.math3.ode.ExpandableStatefulODE,16,14,2,14,0,87.5,0.0,56,47,9,47,0,0,83.93,0.0,36,31,86.11
commons-math-3.6.1,org.apache.commons.math3.ode.AbstractFieldIntegrator,29,23,6,17,6,79.31,20.69,93,52,41,52,0,0,55.91,0.0,54,38,70.37
commons-math-3.6.1,org.apache.commons.math3.ode.SecondOrderIntegrator,0,0,0,0,0,0.0,0.0,0,0,0,0,0,0,0.0,0.0,0,0,0
commons-math-3.6.1,org.apache.commons.math3.ode.ParameterJacobianProvider,0,0,0,0,0,0.0,0.0,0,0,0,0,0,0,0.0,0.0,0,0,0
commons-math-3.6.1,org.apache.commons.math3.ode.FirstOrderConverter,2,2,0,2,0,100.0,0.0,11,11,0,11,0,0,100.0,0.0,7,7,100.0
commons-math-3.6.1,org.apache.commons.math3.ode.ContinuousOutputFieldModel,8,8,0,7,1,100.0,12.5,100,96,4,96,0,0,96.0,0.0,71,39,54.93
commons-math-3.6.1,org.apache.commons.math3.ode.ParameterConfiguration,3,3,0,2,1,100.0,33.33,5,5,0,5,0,0,100.0,0.0,2,2,100.0
commons-math-3.6.1,org.apache.commons.math3.ode.MultistepFieldIntegrator,12,7,5,6,1,58.33,8.33,44,37,7,37,0,0,84.09,0.0,20,11,55.0
commons-math-3.6.1,org.apache.commons.math3.ode.ODEIntegrator,0,0,0,0,0,0.0,0.0,0,0,0,0,0,0,0.0,0.0,0,0,0
commons-math-3.6.1,org.apache.commons.math3.ode.FirstOrderFieldDifferentialEquations,0,0,0,0,0,0.0,0.0,0,0,0,0,0,0,0.0,0.0,0,0,0
commons-math-3.6.1,org.apache.commons.math3.ode.FieldODEStateAndDerivative,2,2,0,2,0,100.0,0.0,4,4,0,4,0,0,100.0,0.0,4,4,100.0
commons-math-3.6.1,org.apache.commons.math3.ode.FieldODEState,7,7,0,7,0,100.0,0.0,16,16,0,16,0,0,100.0,0.0,15,15,100.0
commons-math-3.6.1,org.apache.commons.math3.ode.JacobianMatrices$MainStateJacobianWrapper,3,3,0,3,0,100.0,0.0,15,13,2,13,0,0,86.67,0.0,10,10,100.0
commons-math-3.6.1,org.apache.commons.math3.ode.sampling.FieldStepNormalizer,4,0,4,0,0,0.0,0.0,42,0,42,0,0,0,0.0,0.0,28,0,0.0
commons-math-3.6.1,org.apache.commons.math3.ode.sampling.NordsieckStepInterpolator,8,7,1,7,0,87.5,0.0,78,69,9,69,0,0,88.46,0.0,58,40,68.97
commons-math-3.6.1,org.apache.commons.math3.ode.sampling.DummyStepHandler$LazyHolder,0,0,0,0,0,0.0,0.0,0,0,0,0,0,0,0.0,0.0,0,0,0
commons-math-3.6.1,org.apache.commons.math3.ode.sampling.StepNormalizerBounds,2,2,0,2,0,100.0,0.0,4,4,0,4,0,0,100.0,0.0,4,4,100.0
commons-math-3.6.1,org.apache.commons.math3.ode.sampling.FieldStepHandler,0,0,0,0,0,0.0,0.0,0,0,0,0,0,0,0.0,0.0,0,0,0
commons-math-3.6.1,org.apache.commons.math3.ode.sampling.AbstractStepInterpolator,22,21,1,20,1,95.45,4.55,176,158,18,158,0,0,89.77,0.0,63,54,85.71
commons-math-3.6.1,org.apache.commons.math3.ode.sampling.StepNormalizerMode,0,0,0,0,0,0.0,0.0,0,0,0,0,0,0,0.0,0.0,0,0,0
commons-math-3.6.1,org.apache.commons.math3.ode.sampling.FieldFixedStepHandler,0,0,0,0,0,0.0,0.0,0,0,0,0,0,0,0.0,0.0,0,0,0
commons-math-3.6.1,org.apache.commons.math3.ode.sampling.AbstractFieldStepInterpolator,7,6,1,6,0,85.71,0.0,13,12,1,12,0,0,92.31,0.0,8,8,100.0
commons-math-3.6.1,org.apache.commons.math3.ode.sampling.StepInterpolator,0,0,0,0,0,0.0,0.0,0,0,0,0,0,0,0.0,0.0,0,0,0
commons-math-3.6.1,org.apache.commons.math3.ode.sampling.FieldStepInterpolator,0,0,0,0,0,0.0,0.0,0,0,0,0,0,0,0.0,0.0,0,0,0
commons-math-3.6.1,org.apache.commons.math3.ode.sampling.DummyStepHandler,2,0,2,0,0,0.0,0.0,2,0,2,0,0,0,0.0,0.0,2,0,0.0
commons-math-3.6.1,org.apache.commons.math3.ode.sampling.StepHandler,0,0,0,0,0,0.0,0.0,0,0,0,0,0,0,0.0,0.0,0,0,0
commons-math-3.6.1,org.apache.commons.math3.ode.sampling.FixedStepHandler,0,0,0,0,0,0.0,0.0,0,0,0,0,0,0,0.0,0.0,0,0,0
commons-math-3.6.1,org.apache.commons.math3.ode.sampling.StepNormalizer,5,5,0,4,1,100.0,20.0,54,52,2,52,0,0,96.3,0.0,39,23,58.97
commons-math-3.6.1,org.apache.commons.math3.ode.nonstiff.GillFieldStepInterpolator,2,1,1,1,0,50.0,0.0,10,9,1,9,0,0,90.0,0.0,5,5,100.0
commons-math-3.6.1,org.apache.commons.math3.ode.nonstiff.GillFieldIntegrator,4,3,1,3,0,75.0,0.0,20,19,1,19,0,0,95.0,0.0,7,7,100.0
commons-math-3.6.1,org.apache.commons.math3.ode.nonstiff.AdamsBashforthIntegrator,2,2,0,2,0,100.0,0.0,69,64,5,64,0,0,92.75,0.0,80,26,32.5
commons-math-3.6.1,org.apache.commons.math3.ode.nonstiff.AdaptiveStepsizeFieldIntegrator,9,6,3,5,1,66.67,11.11,76,62,14,62,0,0,81.58,0.0,42,17,40.48
commons-math-3.6.1,org.apache.commons.math3.ode.nonstiff.ClassicalRungeKuttaFieldStepInterpolator,2,1,1,1,0,50.0,0.0,8,7,1,7,0,0,87.5,0.0,5,4,80.0
commons-math-3.6.1,org.apache.commons.math3.ode.nonstiff.AdamsBashforthFieldIntegrator,2,2,0,2,0,100.0,0.0,54,52,2,52,0,0,96.3,0.0,45,21,46.67
commons-math-3.6.1,org.apache.commons.math3.ode.nonstiff.RungeKuttaIntegrator,2,2,0,2,0,100.0,0.0,82,80,2,80,0,0,97.56,0.0,98,85,86.73
commons-math-3.6.1,org.apache.commons.math3.ode.nonstiff.ThreeEighthesFieldIntegrator,4,3,1,3,0,75.0,0.0,20,19,1,19,0,0,95.0,0.0,7,7,100.0
commons-math-3.6.1,org.apache.commons.math3.ode.nonstiff.AdamsNordsieckFieldTransformer,5,5,0,4,1,100.0,20.0,49,49,0,49,0,0,100.0,0.0,52,42,80.77
commons-math-3.6.1,org.apache.commons.math3.ode.nonstiff.AdamsMoultonFieldIntegrator$Corrector,3,3,0,3,0,100.0,0.0,17,17,0,17,0,0,100.0,0.0,9,8,88.89
commons-math-3.6.1,org.apache.commons.math3.ode.nonstiff.HighamHall54StepInterpolator,2,2,0,2,0,100.0,0.0,11,11,0,11,0,0,100.0,0.0,145,144,99.31
commons-math-3.6.1,org.apache.commons.math3.ode.nonstiff.LutherStepInterpolator,2,2,0,2,0,100.0,0.0,11,11,0,11,0,0,100.0,0.0,264,254,96.21
commons-math-3.6.1,org.apache.commons.math3.ode.nonstiff.AdamsMoultonFieldIntegrator,1,1,0,1,0,100.0,0.0,47,45,2,45,0,0,95.74,0.0,38,14,36.84
commons-math-3.6.1,org.apache.commons.math3.ode.nonstiff.AdamsFieldStepInterpolator,3,2,1,2,0,66.67,0.0,23,22,1,22,0,0,95.65,0.0,13,10,76.92
commons-math-3.6.1,org.apache.commons.math3.ode.nonstiff.EulerFieldStepInterpolator,2,1,1,1,0,50.0,0.0,8,7,1,7,0,0,87.5,0.0,5,2,40.0
commons-math-3.6.1,org.apache.commons.math3.ode.nonstiff.ThreeEighthesStepInterpolator,2,2,0,2,0,100.0,0.0,11,11,0,11,0,0,100.0,0.0,85,85,100.0
commons-math-3.6.1,org.apache.commons.math3.ode.nonstiff.DormandPrince853Integrator,2,2,0,2,0,100.0,0.0,12,12,0,12,0,0,100.0,0.0,52,30,57.69
commons-math-3.6.1,org.apache.commons.math3.ode.nonstiff.AdamsMoultonIntegrator,1,1,0,1,0,100.0,0.0,62,57,5,57,0,0,91.94,0.0,62,26,41.94
commons-math-3.6.1,org.apache.commons.math3.ode.nonstiff.RungeKuttaFieldIntegrator,3,1,2,1,0,33.33,0.0,69,5,64,5,0,0,7.25,0.0,58,47,81.03
commons-math-3.6.1,org.apache.commons.math3.ode.nonstiff.FieldButcherArrayProvider,0,0,0,0,0,0.0,0.0,0,0,0,0,0,0,0.0,0.0,0,0,0
commons-math-3.6.1,org.apache.commons.math3.ode.nonstiff.DormandPrince853FieldStepInterpolator,3,2,1,2,0,66.67,0.0,130,129,1,129,0,0,99.23,0.0,10,9,90.0
commons-math-3.6.1,org.apache.commons.math3.ode.nonstiff.EulerIntegrator,0,0,0,0,0,0.0,0.0,0,0,0,0,0,0,0.0,0.0,0,0,0
commons-math-3.6.1,org.apache.commons.math3.ode.nonstiff.AdaptiveStepsizeIntegrator,10,10,0,7,3,100.0,30.0,86,80,6,80,0,0,93.02,0.0,73,45,61.64
commons-math-3.6.1,org.apache.commons.math3.ode.nonstiff.ClassicalRungeKuttaFieldIntegrator,4,3,1,3,0,75.0,0.0,20,19,1,19,0,0,95.0,0.0,7,7,100.0
commons-math-3.6.1,org.apache.commons.math3.ode.nonstiff.LutherIntegrator,0,0,0,0,0,0.0,0.0,0,0,0,0,0,0,0.0,0.0,0,0,0
commons-math-3.6.1,org.apache.commons.math3.ode.nonstiff.ClassicalRungeKuttaStepInterpolator,2,2,0,2,0,100.0,0.0,11,11,0,11,0,0,100.0,0.0,70,69,98.57
commons-math-3.6.1,org.apache.commons.math3.ode.nonstiff.GraggBulirschStoerStepInterpolator,7,7,0,7,0,100.0,0.0,117,101,16,101,0,0,86.32,0.0,167,139,83.23
commons-math-3.6.1,org.apache.commons.math3.ode.nonstiff.AdamsFieldIntegrator,3,3,0,3,0,100.0,0.0,5,5,0,5,0,0,100.0,0.0,3,3,100.0
commons-math-3.6.1,org.apache.commons.math3.ode.nonstiff.DormandPrince54Integrator,2,2,0,2,0,100.0,0.0,6,6,0,6,0,0,100.0,0.0,25,24,96.0
commons-math-3.6.1,org.apache.commons.math3.ode.nonstiff.LutherFieldStepInterpolator,2,1,1,1,0,50.0,0.0,22,21,1,21,0,0,95.45,0.0,5,3,60.0
commons-math-3.6.1,org.apache.commons.math3.ode.nonstiff.DormandPrince54StepInterpolator,4,4,0,4,0,100.0,0.0,51,51,0,51,0,0,100.0,0.0,76,73,96.05
commons-math-3.6.1,org.apache.commons.math3.ode.nonstiff.RungeKuttaStepInterpolator,4,4,0,4,0,100.0,0.0,48,45,3,45,0,0,93.75,0.0,29,23,79.31
commons-math-3.6.1,org.apache.commons.math3.ode.nonstiff.MidpointIntegrator,0,0,0,0,0,0.0,0.0,0,0,0,0,0,0,0.0,0.0,0,0,0
commons-math-3.6.1,org.apache.commons.math3.ode.nonstiff.MidpointFieldStepInterpolator,2,1,1,1,0,50.0,0.0,8,7,1,7,0,0,87.5,0.0,5,4,80.0
commons-math-3.6.1,org.apache.commons.math3.ode.nonstiff.AdamsNordsieckTransformer,6,5,1,4,1,83.33,16.67,54,53,1,53,0,0,98.15,0.0,67,66,98.51
commons-math-3.6.1,org.apache.commons.math3.ode.nonstiff.ClassicalRungeKuttaIntegrator,0,0,0,0,0,0.0,0.0,0,0,0,0,0,0,0.0,0.0,0,0,0
commons-math-3.6.1,org.apache.commons.math3.ode.nonstiff.ThreeEighthesIntegrator,0,0,0,0,0,0.0,0.0,0,0,0,0,0,0,0.0,0.0,0,0,0
commons-math-3.6.1,org.apache.commons.math3.ode.nonstiff.ThreeEighthesFieldStepInterpolator,2,1,1,1,0,50.0,0.0,8,7,1,7,0,0,87.5,0.0,5,5,100.0
commons-math-3.6.1,org.apache.commons.math3.ode.nonstiff.MidpointFieldIntegrator,4,3,1,3,0,75.0,0.0,8,7,1,7,0,0,87.5,0.0,4,4,100.0
commons-math-3.6.1,org.apache.commons.math3.ode.nonstiff.DormandPrince54FieldIntegrator,6,6,0,6,0,100.0,0.0,59,53,6,53,0,0,89.83,0.0,12,11,91.67
commons-math-3.6.1,org.apache.commons.math3.ode.nonstiff.HighamHall54FieldStepInterpolator,2,1,1,1,0,50.0,0.0,8,7,1,7,0,0,87.5,0.0,5,4,80.0
commons-math-3.6.1,org.apache.commons.math3.ode.nonstiff.AdamsMoultonIntegrator$Corrector,3,3,0,3,0,100.0,0.0,17,17,0,17,0,0,100.0,0.0,22,16,72.73
commons-math-3.6.1,org.apache.commons.math3.ode.nonstiff.DormandPrince853StepInterpolator,7,7,0,7,0,100.0,0.0,99,97,2,97,0,0,97.98,0.0,246,241,97.97
commons-math-3.6.1,org.apache.commons.math3.ode.nonstiff.EmbeddedRungeKuttaIntegrator,7,7,0,7,0,100.0,0.0,102,102,0,102,0,0,100.0,0.0,96,63,65.62
commons-math-3.6.1,org.apache.commons.math3.ode.nonstiff.GraggBulirschStoerIntegrator,11,11,0,11,0,100.0,0.0,338,328,10,328,0,0,97.04,0.0,395,257,65.06
commons-math-3.6.1,org.apache.commons.math3.ode.nonstiff.LutherFieldIntegrator,4,3,1,3,0,75.0,0.0,41,40,1,40,0,0,97.56,0.0,7,7,100.0
commons-math-3.6.1,org.apache.commons.math3.ode.nonstiff.GillStepInterpolator,2,2,0,2,0,100.0,0.0,11,11,0,11,0,0,100.0,0.0,76,76,100.0
commons-math-3.6.1,org.apache.commons.math3.ode.nonstiff.MidpointStepInterpolator,2,2,0,2,0,100.0,0.0,11,11,0,11,0,0,100.0,0.0,30,29,96.67
commons-math-3.6.1,org.apache.commons.math3.ode.nonstiff.HighamHall54Integrator,2,2,0,2,0,100.0,0.0,10,10,0,10,0,0,100.0,0.0,19,10,52.63
commons-math-3.6.1,org.apache.commons.math3.ode.nonstiff.EulerStepInterpolator,2,2,0,2,0,100.0,0.0,11,11,0,11,0,0,100.0,0.0,15,13,86.67
commons-math-3.6.1,org.apache.commons.math3.ode.nonstiff.EulerFieldIntegrator,4,3,1,2,1,75.0,25.0,5,4,1,4,0,0,80.0,0.0,4,4,100.0
commons-math-3.6.1,org.apache.commons.math3.ode.nonstiff.AdamsIntegrator,3,3,0,3,0,100.0,0.0,5,5,0,5,0,0,100.0,0.0,3,3,100.0
commons-math-3.6.1,org.apache.commons.math3.ode.nonstiff.DormandPrince54FieldStepInterpolator,2,1,1,1,0,50.0,0.0,19,18,1,18,0,0,94.74,0.0,5,4,80.0
commons-math-3.6.1,org.apache.commons.math3.ode.nonstiff.HighamHall54FieldIntegrator,6,4,2,3,1,66.67,16.67,67,49,18,49,0,0,73.13,0.0,14,11,78.57
commons-math-3.6.1,org.apache.commons.math3.ode.nonstiff.EmbeddedRungeKuttaFieldIntegrator,9,6,3,6,0,66.67,0.0,89,86,3,86,0,0,96.63,0.0,61,28,45.9
commons-math-3.6.1,org.apache.commons.math3.ode.nonstiff.DormandPrince853FieldIntegrator,6,6,0,6,0,100.0,0.0,202,200,2,200,0,0,99.01,0.0,14,12,85.71
commons-math-3.6.1,org.apache.commons.math3.ode.nonstiff.GillIntegrator,0,0,0,0,0,0.0,0.0,0,0,0,0,0,0,0.0,0.0,0,0,0
commons-math-3.6.1,org.apache.commons.math3.ode.nonstiff.RungeKuttaFieldStepInterpolator,5,4,1,4,0,80.0,0.0,15,14,1,14,0,0,93.33,0.0,9,9,100.0
commons-math-3.6.1,org.apache.commons.math3.ode.events.FilterType,4,4,0,2,2,100.0,50.0,106,102,4,102,0,0,96.23,0.0,0,0,0
commons-math-3.6.1,org.apache.commons.math3.ode.events.EventFilter,4,3,1,3,0,75.0,0.0,45,42,3,42,0,0,93.33,0.0,38,23,60.53
commons-math-3.6.1,org.apache.commons.math3.ode.events.EventState,13,10,3,10,0,76.92,0.0,100,91,9,91,0,0,91.0,0.0,94,74,78.72
commons-math-3.6.1,org.apache.commons.math3.ode.events.Action,0,0,0,0,0,0.0,0.0,0,0,0,0,0,0,0.0,0.0,0,0,0
commons-math-3.6.1,org.apache.commons.math3.ode.events.EventHandler$Action,0,0,0,0,0,0.0,0.0,0,0,0,0,0,0,0.0,0.0,0,0,0
commons-math-3.6.1,org.apache.commons.math3.ode.events.EventHandler,0,0,0,0,0,0.0,0.0,0,0,0,0,0,0,0.0,0.0,0,0,0
commons-math-3.6.1,org.apache.commons.math3.ode.events.FieldEventHandler,0,0,0,0,0,0.0,0.0,0,0,0,0,0,0,0.0,0.0,0,0,0
commons-math-3.6.1,org.apache.commons.math3.ode.events.EventState$LocalMaxCountExceededException,1,0,1,0,0,0.0,0.0,2,0,2,0,0,0,0.0,0.0,1,0,0.0
commons-math-3.6.1,org.apache.commons.math3.ode.events.FieldEventState,11,0,11,0,0,0.0,0.0,83,0,83,0,0,0,0.0,0.0,66,24,36.36
commons-math-3.6.1,org.apache.commons.math3.ode.events.Transformer,5,5,0,4,1,100.0,20.0,5,5,0,5,0,0,100.0,0.0,0,0,0
commons-math-3.6.1,org.apache.commons.math3.stat.Frequency,35,34,1,32,2,97.14,5.71,147,133,14,133,0,0,90.48,0.0,83,67,80.72
commons-math-3.6.1,org.apache.commons.math3.stat.Frequency$NaturalComparator,1,1,0,1,0,100.0,0.0,1,1,0,1,0,0,100.0,0.0,1,1,100.0
commons-math-3.6.1,org.apache.commons.math3.stat.StatUtils,33,30,3,30,0,90.91,0.0,92,78,14,78,0,0,84.78,0.0,77,62,80.52
commons-math-3.6.1,org.apache.commons.math3.stat.ranking.RankingAlgorithm,0,0,0,0,0,0.0,0.0,0,0,0,0,0,0,0.0,0.0,0,0,0
commons-math-3.6.1,org.apache.commons.math3.stat.ranking.TiesStrategy,0,0,0,0,0,0.0,0.0,0,0,0,0,0,0,0.0,0.0,0,0,0
commons-math-3.6.1,org.apache.commons.math3.stat.ranking.NaturalRanking,10,9,1,8,1,90.0,10.0,130,121,9,121,0,0,93.08,0.0,66,61,92.42
commons-math-3.6.1,org.apache.commons.math3.stat.ranking.NaNStrategy,0,0,0,0,0,0.0,0.0,0,0,0,0,0,0,0.0,0.0,0,0,0
commons-math-3.6.1,org.apache.commons.math3.stat.ranking.NaturalRanking$IntDoublePair,3,3,0,3,0,100.0,0.0,5,5,0,5,0,0,100.0,0.0,3,3,100.0
commons-math-3.6.1,org.apache.commons.math3.stat.interval.BinomialConfidenceInterval,0,0,0,0,0,0.0,0.0,0,0,0,0,0,0,0.0,0.0,0,0,0
commons-math-3.6.1,org.apache.commons.math3.stat.interval.NormalApproximationInterval,1,1,0,1,0,100.0,0.0,2,2,0,2,0,0,100.0,0.0,13,13,100.0
commons-math-3.6.1,org.apache.commons.math3.stat.interval.ClopperPearsonInterval,1,1,0,1,0,100.0,0.0,10,10,0,10,0,0,100.0,0.0,30,26,86.67
commons-math-3.6.1,org.apache.commons.math3.stat.interval.WilsonScoreInterval,1,1,0,1,0,100.0,0.0,2,2,0,2,0,0,100.0,0.0,27,27,100.0
commons-math-3.6.1,org.apache.commons.math3.stat.interval.ConfidenceInterval,5,4,1,2,2,80.0,40.0,14,9,5,9,0,0,64.29,0.0,10,5,50.0
commons-math-3.6.1,org.apache.commons.math3.stat.interval.AgrestiCoullInterval,1,1,0,1,0,100.0,0.0,2,2,0,2,0,0,100.0,0.0,17,17,100.0
commons-math-3.6.1,org.apache.commons.math3.stat.interval.IntervalUtils,5,5,0,5,0,100.0,0.0,16,16,0,16,0,0,100.0,0.0,14,10,71.43
commons-math-3.6.1,org.apache.commons.math3.stat.correlation.SpearmansCorrelation,8,7,1,7,0,87.5,0.0,59,54,5,54,0,0,91.53,0.0,36,33,91.67
commons-math-3.6.1,org.apache.commons.math3.stat.correlation.PearsonsCorrelation,8,8,0,8,0,100.0,0.0,77,73,4,73,0,0,94.81,0.0,55,51,92.73
commons-math-3.6.1,org.apache.commons.math3.stat.correlation.Covariance,9,8,1,7,1,88.89,11.11,45,40,5,40,0,0,88.89,0.0,35,32,91.43
commons-math-3.6.1,org.apache.commons.math3.stat.correlation.KendallsCorrelation,6,6,0,6,0,100.0,0.0,90,88,2,80,8,6,97.78,8.89,79,74,93.67
commons-math-3.6.1,org.apache.commons.math3.stat.correlation.StorelessBivariateCovariance,4,3,1,3,0,75.0,0.0,21,17,4,13,4,4,80.95,19.05,36,32,88.89
commons-math-3.6.1,org.apache.commons.math3.stat.correlation.StorelessCovariance,10,7,3,7,0,70.0,0.0,37,25,12,25,0,0,67.57,0.0,36,27,75.0
commons-math-3.6.1,org.apache.commons.math3.stat.clustering.KMeansPlusPlusClusterer,8,8,0,8,0,100.0,0.0,164,149,15,149,0,0,90.85,0.0,78,41,52.56
commons-math-3.6.1,org.apache.commons.math3.stat.clustering.Clusterable,0,0,0,0,0,0.0,0.0,0,0,0,0,0,0,0.0,0.0,0,0,0
commons-math-3.6.1,org.apache.commons.math3.stat.clustering.KMeansPlusPlusClusterer$EmptyClusterStrategy,0,0,0,0,0,0.0,0.0,0,0,0,0,0,0,0.0,0.0,0,0,0
commons-math-3.6.1,org.apache.commons.math3.stat.clustering.EuclideanDoublePoint,6,5,1,3,2,83.33,33.33,17,14,3,14,0,0,82.35,0.0,15,11,73.33
commons-math-3.6.1,org.apache.commons.math3.stat.clustering.Cluster,3,3,0,3,0,100.0,0.0,5,5,0,5,0,0,100.0,0.0,2,2,100.0
commons-math-3.6.1,org.apache.commons.math3.stat.clustering.EuclideanIntegerPoint,6,5,1,3,2,83.33,33.33,18,15,3,15,0,0,83.33,0.0,15,11,73.33
commons-math-3.6.1,org.apache.commons.math3.stat.clustering.DBSCANClusterer$PointStatus,0,0,0,0,0,0.0,0.0,0,0,0,0,0,0,0.0,0.0,0,0,0
commons-math-3.6.1,org.apache.commons.math3.stat.clustering.DBSCANClusterer,6,6,0,6,0,100.0,0.0,48,48,0,48,0,0,100.0,0.0,23,22,95.65
commons-math-3.6.1,org.apache.commons.math3.stat.inference.KolmogorovSmirnovTest,31,27,4,25,2,87.1,6.45,388,296,92,296,0,0,76.29,0.0,483,349,72.26
commons-math-3.6.1,org.apache.commons.math3.stat.inference.BinomialTest,2,2,0,2,0,100.0,0.0,43,32,11,32,0,0,74.42,0.0,34,20,58.82
commons-math-3.6.1,org.apache.commons.math3.stat.inference.ChiSquareTest,10,10,0,10,0,100.0,0.0,115,109,6,109,0,0,94.78,0.0,114,98,85.96
commons-math-3.6.1,org.apache.commons.math3.stat.inference.OneWayAnova,6,6,0,6,0,100.0,0.0,36,34,2,34,0,0,94.44,0.0,39,32,82.05
commons-math-3.6.1,org.apache.commons.math3.stat.inference.WilcoxonSignedRankTest,7,7,0,7,0,100.0,0.0,55,50,5,50,0,0,90.91,0.0,64,57,89.06
commons-math-3.6.1,org.apache.commons.math3.stat.inference.MannWhitneyUTest,5,5,0,5,0,100.0,0.0,20,19,1,19,0,0,95.0,0.0,33,30,90.91
commons-math-3.6.1,org.apache.commons.math3.stat.inference.AlternativeHypothesis,0,0,0,0,0,0.0,0.0,0,0,0,0,0,0,0.0,0.0,0,0,0
commons-math-3.6.1,org.apache.commons.math3.stat.inference.GTest,10,10,0,10,0,100.0,0.0,91,87,4,87,0,0,95.6,0.0,100,90,90.0
commons-math-3.6.1,org.apache.commons.math3.stat.inference.OneWayAnova$AnovaStats,0,0,0,0,0,0.0,0.0,3,3,0,3,0,0,100.0,0.0,0,0,0
commons-math-3.6.1,org.apache.commons.math3.stat.inference.TTest,30,29,1,29,0,96.67,0.0,72,69,3,69,0,0,95.83,0.0,127,100,78.74
commons-math-3.6.1,org.apache.commons.math3.stat.inference.TestUtils,50,39,11,36,3,78.0,6.0,50,39,11,39,0,0,78.0,0.0,63,47,74.6
commons-math-3.6.1,org.apache.commons.math3.stat.descriptive.AbstractStorelessUnivariateStatistic,6,6,0,6,0,100.0,0.0,28,26,2,26,0,0,92.86,0.0,24,21,87.5
commons-math-3.6.1,org.apache.commons.math3.stat.descriptive.SynchronizedMultivariateSummaryStatistics,30,30,0,30,0,100.0,0.0,30,30,0,24,6,6,100.0,20.0,31,31,100.0
commons-math-3.6.1,org.apache.commons.math3.stat.descriptive.SynchronizedDescriptiveStatistics,13,12,1,10,2,92.31,15.38,17,15,2,15,0,0,88.24,0.0,16,13,81.25
commons-math-3.6.1,org.apache.commons.math3.stat.descriptive.UnivariateStatistic,0,0,0,0,0,0.0,0.0,0,0,0,0,0,0,0.0,0.0,0,0,0
commons-math-3.6.1,org.apache.commons.math3.stat.descriptive.AggregateSummaryStatistics$AggregatingSummaryStatistics,3,1,2,1,0,33.33,0.0,11,2,9,2,0,0,18.18,0.0,12,2,16.67
commons-math-3.6.1,org.apache.commons.math3.stat.descriptive.SynchronizedSummaryStatistics,35,23,12,22,1,65.71,2.86,39,23,16,23,0,0,58.97,0.0,39,23,58.97
commons-math-3.6.1,org.apache.commons.math3.stat.descriptive.WeightedEvaluation,0,0,0,0,0,0.0,0.0,0,0,0,0,0,0,0.0,0.0,0,0,0
commons-math-3.6.1,org.apache.commons.math3.stat.descriptive.AggregateSummaryStatistics,14,9,5,9,0,64.29,0.0,41,33,8,33,0,0,80.49,0.0,42,34,80.95
commons-math-3.6.1,org.apache.commons.math3.stat.descriptive.StatisticalMultivariateSummary,0,0,0,0,0,0.0,0.0,0,0,0,0,0,0,0.0,0.0,0,0,0
commons-math-3.6.1,org.apache.commons.math3.stat.descriptive.StorelessUnivariateStatistic,0,0,0,0,0,0.0,0.0,0,0,0,0,0,0,0.0,0.0,0,0,0
commons-math-3.6.1,org.apache.commons.math3.stat.descriptive.StatisticalSummary,0,0,0,0,0,0.0,0.0,0,0,0,0,0,0,0.0,0.0,0,0,0
commons-math-3.6.1,org.apache.commons.math3.stat.descriptive.StatisticalSummaryValues,10,10,0,9,1,100.0,10.0,39,39,0,39,0,0,100.0,0.0,31,19,61.29
commons-math-3.6.1,org.apache.commons.math3.stat.descriptive.MultivariateSummaryStatistics,35,35,0,34,1,100.0,2.86,131,131,0,125,6,6,100.0,4.58,110,88,80.0
commons-math-3.6.1,org.apache.commons.math3.stat.descriptive.DescriptiveStatistics,47,46,1,45,1,97.87,2.13,118,110,8,110,0,0,93.22,0.0,61,53,86.89
commons-math-3.6.1,org.apache.commons.math3.stat.descriptive.SummaryStatistics,38,29,9,25,4,76.32,10.53,172,146,26,138,8,4,84.88,4.65,120,64,53.33
commons-math-3.6.1,org.apache.commons.math3.stat.descriptive.AbstractUnivariateStatistic,10,8,2,7,1,80.0,10.0,24,9,15,9,0,0,37.5,0.0,24,9,37.5
commons-math-3.6.1,org.apache.commons.math3.stat.descriptive.moment.VectorialMean,5,4,1,3,1,80.0,20.0,30,21,9,16,5,0,70.0,16.67,19,12,63.16
commons-math-3.6.1,org.apache.commons.math3.stat.descriptive.moment.Skewness,7,7,0,7,0,100.0,0.0,48,47,1,47,0,0,97.92,0.0,55,46,83.64
commons-math-3.6.1,org.apache.commons.math3.stat.descriptive.moment.FirstMoment,6,6,0,6,0,100.0,0.0,29,28,1,28,0,0,96.55,0.0,12,9,75.0
commons-math-3.6.1,org.apache.commons.math3.stat.descriptive.moment.SemiVariance,11,4,7,4,0,36.36,0.0,42,25,17,22,3,1,59.52,7.14,29,18,62.07
commons-math-3.6.1,org.apache.commons.math3.stat.descriptive.moment.ThirdMoment,5,5,0,5,0,100.0,0.0,23,23,0,23,0,0,100.0,0.0,20,18,90.0
commons-math-3.6.1,org.apache.commons.math3.stat.descriptive.moment.VectorialCovariance,6,5,1,4,1,83.33,16.67,59,41,18,33,8,0,69.49,13.56,56,33,58.93
commons-math-3.6.1,org.apache.commons.math3.stat.descriptive.moment.StandardDeviation,12,9,3,9,0,75.0,0.0,22,17,5,16,1,1,77.27,4.55,16,9,56.25
commons-math-3.6.1,org.apache.commons.math3.stat.descriptive.moment.GeometricMean,10,9,1,8,1,90.0,10.0,24,20,4,20,0,0,83.33,0.0,19,13,68.42
commons-math-3.6.1,org.apache.commons.math3.stat.descriptive.moment.Kurtosis,7,7,0,7,0,100.0,0.0,47,46,1,46,0,0,97.87,0.0,62,56,90.32
commons-math-3.6.1,org.apache.commons.math3.stat.descriptive.moment.Variance,16,14,2,14,0,87.5,0.0,117,105,12,103,2,0,89.74,1.71,88,63,71.59
commons-math-3.6.1,org.apache.commons.math3.stat.descriptive.moment.FourthMoment,5,5,0,5,0,100.0,0.0,23,22,1,22,0,0,95.65,0.0,26,24,92.31
commons-math-3.6.1,org.apache.commons.math3.stat.descriptive.moment.SemiVariance$Direction,1,1,0,1,0,100.0,0.0,2,2,0,2,0,0,100.0,0.0,2,2,100.0
commons-math-3.6.1,org.apache.commons.math3.stat.descriptive.moment.Mean,9,9,0,9,0,100.0,0.0,44,42,2,42,0,0,95.45,0.0,35,25,71.43
commons-math-3.6.1,org.apache.commons.math3.stat.descriptive.moment.SecondMoment,5,5,0,5,0,100.0,0.0,17,16,1,16,0,0,94.12,0.0,14,12,85.71
commons-math-3.6.1,org.apache.commons.math3.stat.descriptive.rank.PSquarePercentile$Markers,14,14,0,12,2,100.0,14.29,72,72,0,72,0,0,100.0,0.0,62,56,90.32
commons-math-3.6.1,org.apache.commons.math3.stat.descriptive.rank.Median,3,2,1,2,0,66.67,0.0,3,2,1,2,0,0,66.67,0.0,3,2,66.67
commons-math-3.6.1,org.apache.commons.math3.stat.descriptive.rank.PSquarePercentile$PSquareMarkers,0,0,0,0,0,0.0,0.0,0,0,0,0,0,0,0.0,0.0,0,0,0
commons-math-3.6.1,org.apache.commons.math3.stat.descriptive.rank.Min,7,7,0,7,0,100.0,0.0,29,28,1,28,0,0,96.55,0.0,19,14,73.68
commons-math-3.6.1,org.apache.commons.math3.stat.descriptive.rank.PSquarePercentile,12,12,0,10,2,100.0,16.67,73,73,0,72,1,0,100.0,1.37,42,38,90.48
commons-math-3.6.1,org.apache.commons.math3.stat.descriptive.rank.Max,7,7,0,7,0,100.0,0.0,29,28,1,28,0,0,96.55,0.0,19,14,73.68
commons-math-3.6.1,org.apache.commons.math3.stat.descriptive.rank.PSquarePercentile$FixedCapacityList,2,2,0,2,0,100.0,0.0,4,4,0,4,0,0,100.0,0.0,9,6,66.67
commons-math-3.6.1,org.apache.commons.math3.stat.descriptive.rank.PSquarePercentile$Marker,13,13,0,10,3,100.0,23.08,49,47,2,47,0,0,95.92,0.0,58,48,82.76
commons-math-3.6.1,org.apache.commons.math3.stat.descriptive.rank.Percentile,23,21,2,20,1,91.3,4.35,113,103,10,103,0,0,91.15,0.0,66,58,87.88
commons-math-3.6.1,org.apache.commons.math3.stat.descriptive.rank.Percentile$EstimationType,16,16,0,16,0,100.0,0.0,27,26,1,26,0,0,96.3,0.0,22,20,90.91
commons-math-3.6.1,org.apache.commons.math3.stat.descriptive.summary.SumOfLogs,7,7,0,7,0,100.0,0.0,25,24,1,24,0,0,96.0,0.0,15,12,80.0
commons-math-3.6.1,org.apache.commons.math3.stat.descriptive.summary.Sum,9,8,1,8,0,88.89,0.0,34,32,2,32,0,0,94.12,0.0,23,19,82.61
commons-math-3.6.1,org.apache.commons.math3.stat.descriptive.summary.Product,9,9,0,9,0,100.0,0.0,34,33,1,33,0,0,97.06,0.0,22,19,86.36
commons-math-3.6.1,org.apache.commons.math3.stat.descriptive.summary.SumOfSquares,7,7,0,7,0,100.0,0.0,25,24,1,24,0,0,96.0,0.0,17,14,82.35
commons-math-3.6.1,org.apache.commons.math3.stat.regression.MultipleLinearRegression,0,0,0,0,0,0.0,0.0,0,0,0,0,0,0,0.0,0.0,0,0,0
commons-math-3.6.1,org.apache.commons.math3.stat.regression.OLSMultipleLinearRegression,10,10,0,10,0,100.0,0.0,35,35,0,35,0,0,100.0,0.0,38,38,100.0
commons-math-3.6.1,org.apache.commons.math3.stat.regression.MillerUpdatingRegression,21,20,1,20,0,95.24,0.0,579,470,109,470,0,0,81.17,0.0,584,416,71.23
commons-math-3.6.1,org.apache.commons.math3.stat.regression.RegressionResults,15,12,3,11,1,80.0,6.67,105,58,47,57,1,0,55.24,0.95,77,42,54.55
commons-math-3.6.1,org.apache.commons.math3.stat.regression.GLSMultipleLinearRegression,6,5,1,5,0,83.33,0.0,22,19,3,19,0,0,86.36,0.0,12,8,66.67
commons-math-3.6.1,org.apache.commons.math3.stat.regression.ModelSpecificationException,0,0,0,0,0,0.0,0.0,0,0,0,0,0,0,0.0,0.0,0,0,0
commons-math-3.6.1,org.apache.commons.math3.stat.regression.UpdatingMultipleLinearRegression,0,0,0,0,0,0.0,0.0,0,0,0,0,0,0,0.0,0.0,0,0,0
commons-math-3.6.1,org.apache.commons.math3.stat.regression.AbstractMultipleLinearRegression,19,18,1,17,1,94.74,5.26,91,80,11,80,0,0,87.91,0.0,59,51,86.44
commons-math-3.6.1,org.apache.commons.math3.stat.regression.SimpleRegression,30,28,2,26,2,93.33,6.67,205,158,47,158,0,0,77.07,0.0,285,216,75.79
commons-math-3.6.1,org.apache.commons.math3.ml.distance.DistanceMeasure,0,0,0,0,0,0.0,0.0,0,0,0,0,0,0,0.0,0.0,0,0,0
commons-math-3.6.1,org.apache.commons.math3.ml.distance.EarthMoversDistance,1,1,0,1,0,100.0,0.0,8,8,0,8,0,0,100.0,0.0,7,6,85.71
commons-math-3.6.1,org.apache.commons.math3.ml.distance.ManhattanDistance,1,1,0,1,0,100.0,0.0,1,1,0,1,0,0,100.0,0.0,1,1,100.0
commons-math-3.6.1,org.apache.commons.math3.ml.distance.EuclideanDistance,1,1,0,1,0,100.0,0.0,1,1,0,1,0,0,100.0,0.0,1,1,100.0
commons-math-3.6.1,org.apache.commons.math3.ml.distance.CanberraDistance,1,1,0,1,0,100.0,0.0,6,6,0,6,0,0,100.0,0.0,10,9,90.0
commons-math-3.6.1,org.apache.commons.math3.ml.distance.ChebyshevDistance,1,1,0,1,0,100.0,0.0,1,1,0,1,0,0,100.0,0.0,1,1,100.0
commons-math-3.6.1,org.apache.commons.math3.ml.clustering.DoublePoint,4,3,1,1,2,75.0,50.0,12,9,3,9,0,0,75.0,0.0,7,3,42.86
commons-math-3.6.1,org.apache.commons.math3.ml.clustering.Clusterer,2,2,0,2,0,100.0,0.0,3,3,0,3,0,0,100.0,0.0,2,2,100.0
commons-math-3.6.1,org.apache.commons.math3.ml.clustering.KMeansPlusPlusClusterer,12,5,7,5,0,41.67,0.0,161,98,63,98,0,0,60.87,0.0,81,33,40.74
commons-math-3.6.1,org.apache.commons.math3.ml.clustering.FuzzyKMeansClusterer,15,11,4,10,1,73.33,6.67,118,96,22,96,0,0,81.36,0.0,75,40,53.33
commons-math-3.6.1,org.apache.commons.math3.ml.clustering.Clusterable,0,0,0,0,0,0.0,0.0,0,0,0,0,0,0,0.0,0.0,0,0,0
commons-math-3.6.1,org.apache.commons.math3.ml.clustering.KMeansPlusPlusClusterer$EmptyClusterStrategy,0,0,0,0,0,0.0,0.0,0,0,0,0,0,0,0.0,0.0,0,0,0
commons-math-3.6.1,org.apache.commons.math3.ml.clustering.MultiKMeansPlusPlusClusterer,4,1,3,1,0,25.0,0.0,16,13,3,13,0,0,81.25,0.0,7,3,42.86
commons-math-3.6.1,org.apache.commons.math3.ml.clustering.Cluster,2,2,0,2,0,100.0,0.0,3,3,0,3,0,0,100.0,0.0,1,1,100.0
commons-math-3.6.1,org.apache.commons.math3.ml.clustering.DBSCANClusterer$PointStatus,0,0,0,0,0,0.0,0.0,0,0,0,0,0,0,0.0,0.0,0,0,0
commons-math-3.6.1,org.apache.commons.math3.ml.clustering.DBSCANClusterer,6,6,0,6,0,100.0,0.0,48,48,0,48,0,0,100.0,0.0,23,22,95.65
commons-math-3.6.1,org.apache.commons.math3.ml.clustering.CentroidCluster,1,1,0,1,0,100.0,0.0,2,2,0,2,0,0,100.0,0.0,1,1,100.0
commons-math-3.6.1,org.apache.commons.math3.ml.clustering.evaluation.ClusterEvaluator,3,3,0,3,0,100.0,0.0,17,15,2,15,0,0,88.24,0.0,14,13,92.86
commons-math-3.6.1,org.apache.commons.math3.ml.clustering.evaluation.SumOfClusterVariances,1,1,0,1,0,100.0,0.0,8,8,0,8,0,0,100.0,0.0,4,4,100.0
commons-math-3.6.1,org.apache.commons.math3.ml.neuralnet.Neuron$SerializationProxy,1,1,0,1,0,100.0,0.0,3,3,0,3,0,0,100.0,0.0,1,1,100.0
commons-math-3.6.1,org.apache.commons.math3.ml.neuralnet.UpdateAction,0,0,0,0,0,0.0,0.0,0,0,0,0,0,0,0.0,0.0,0,0,0
commons-math-3.6.1,org.apache.commons.math3.ml.neuralnet.Network$NeuronIdentifierComparator,1,1,0,0,1,100.0,100.0,1,1,0,1,0,0,100.0,0.0,4,1,25.0
commons-math-3.6.1,org.apache.commons.math3.ml.neuralnet.SquareNeighbourhood,0,0,0,0,0,0.0,0.0,0,0,0,0,0,0,0.0,0.0,0,0,0
commons-math-3.6.1,org.apache.commons.math3.ml.neuralnet.FeatureInitializer,0,0,0,0,0,0.0,0.0,0,0,0,0,0,0,0.0,0.0,0,0,0
commons-math-3.6.1,org.apache.commons.math3.ml.neuralnet.Neuron,10,9,1,8,1,90.0,10.0,34,28,6,28,0,0,82.35,0.0,21,18,85.71
commons-math-3.6.1,org.apache.commons.math3.ml.neuralnet.Network$SerializationProxy,1,1,0,1,0,100.0,0.0,5,5,0,5,0,0,100.0,0.0,1,1,100.0
commons-math-3.6.1,org.apache.commons.math3.ml.neuralnet.FeatureInitializerFactory,6,5,1,3,2,83.33,33.33,7,6,1,6,0,0,85.71,0.0,4,3,75.0
commons-math-3.6.1,org.apache.commons.math3.ml.neuralnet.Network,18,16,2,15,1,88.89,5.56,88,70,18,70,0,0,79.55,0.0,27,24,88.89
commons-math-3.6.1,org.apache.commons.math3.ml.neuralnet.MapUtils,7,2,5,2,0,28.57,0.0,74,15,59,15,0,0,20.27,0.0,39,6,15.38
commons-math-3.6.1,org.apache.commons.math3.ml.neuralnet.MapUtils$PairNeuronDouble,2,2,0,2,0,100.0,0.0,4,4,0,4,0,0,100.0,0.0,1,1,100.0
commons-math-3.6.1,org.apache.commons.math3.ml.neuralnet.sofm.LearningFactorFunction,0,0,0,0,0,0.0,0.0,0,0,0,0,0,0,0.0,0.0,0,0,0
commons-math-3.6.1,org.apache.commons.math3.ml.neuralnet.sofm.NeighbourhoodSizeFunction,0,0,0,0,0,0.0,0.0,0,0,0,0,0,0,0.0,0.0,0,0,0
commons-math-3.6.1,org.apache.commons.math3.ml.neuralnet.sofm.LearningFactorFunctionFactory,4,4,0,4,0,100.0,0.0,10,10,0,10,0,0,100.0,0.0,10,10,100.0
commons-math-3.6.1,org.apache.commons.math3.ml.neuralnet.sofm.NeighbourhoodSizeFunctionFactory,4,4,0,4,0,100.0,0.0,4,4,0,4,0,0,100.0,0.0,2,2,100.0
commons-math-3.6.1,org.apache.commons.math3.ml.neuralnet.sofm.KohonenUpdateAction,6,5,1,5,0,83.33,0.0,29,28,1,28,0,0,96.55,0.0,14,6,42.86
commons-math-3.6.1,org.apache.commons.math3.ml.neuralnet.sofm.KohonenTrainingTask,1,0,1,0,0,0.0,0.0,6,0,6,0,0,0,0.0,0.0,2,0,0.0
commons-math-3.6.1,org.apache.commons.math3.ml.neuralnet.sofm.util.ExponentialDecayFunction,1,1,0,1,0,100.0,0.0,15,15,0,15,0,0,100.0,0.0,4,4,100.0
commons-math-3.6.1,org.apache.commons.math3.ml.neuralnet.sofm.util.QuasiSigmoidDecayFunction,1,1,0,1,0,100.0,0.0,12,12,0,12,0,0,100.0,0.0,2,2,100.0
commons-math-3.6.1,org.apache.commons.math3.ml.neuralnet.oned.NeuronString,6,4,2,4,0,66.67,0.0,46,38,8,38,0,0,82.61,0.0,26,23,88.46
commons-math-3.6.1,org.apache.commons.math3.ml.neuralnet.oned.NeuronString$SerializationProxy,1,1,0,1,0,100.0,0.0,3,3,0,3,0,0,100.0,0.0,1,1,100.0
commons-math-3.6.1,org.apache.commons.math3.ml.neuralnet.twod.NeuronSquareMesh2D$HorizontalDirection,0,0,0,0,0,0.0,0.0,0,0,0,0,0,0,0.0,0.0,0,0,0
commons-math-3.6.1,org.apache.commons.math3.ml.neuralnet.twod.NeuronSquareMesh2D$VerticalDirection,0,0,0,0,0,0.0,0.0,0,0,0,0,0,0,0.0,0.0,0,0,0
commons-math-3.6.1,org.apache.commons.math3.ml.neuralnet.twod.NeuronSquareMesh2D$SerializationProxy,1,1,0,1,0,100.0,0.0,5,5,0,5,0,0,100.0,0.0,1,1,100.0
commons-math-3.6.1,org.apache.commons.math3.ml.neuralnet.twod.NeuronSquareMesh2D,11,9,2,9,0,81.82,0.0,211,190,21,190,0,0,90.05,0.0,134,127,94.78
commons-math-3.6.1,org.apache.commons.math3.ml.neuralnet.twod.util.TopographicErrorHistogram,1,0,1,0,0,0.0,0.0,15,0,15,0,0,0,0.0,0.0,10,0,0.0
commons-math-3.6.1,org.apache.commons.math3.ml.neuralnet.twod.util.QuantizationError,1,0,1,0,0,0.0,0.0,12,0,12,0,0,0,0.0,0.0,9,0,0.0
commons-math-3.6.1,org.apache.commons.math3.ml.neuralnet.twod.util.HitHistogram,1,0,1,0,0,0.0,0.0,14,0,14,0,0,0,0.0,0.0,9,0,0.0
commons-math-3.6.1,org.apache.commons.math3.ml.neuralnet.twod.util.LocationFinder$Location,2,2,0,2,0,100.0,0.0,4,4,0,4,0,0,100.0,0.0,2,2,100.0
commons-math-3.6.1,org.apache.commons.math3.ml.neuralnet.twod.util.LocationFinder,1,1,0,1,0,100.0,0.0,9,7,2,7,0,0,77.78,0.0,1,1,100.0
commons-math-3.6.1,org.apache.commons.math3.ml.neuralnet.twod.util.MapVisualization,0,0,0,0,0,0.0,0.0,0,0,0,0,0,0,0.0,0.0,0,0,0
commons-math-3.6.1,org.apache.commons.math3.ml.neuralnet.twod.util.MapDataVisualization,0,0,0,0,0,0.0,0.0,0,0,0,0,0,0,0.0,0.0,0,0,0
commons-math-3.6.1,org.apache.commons.math3.ml.neuralnet.twod.util.UnifiedDistanceMatrix,3,0,3,0,0,0.0,0.0,39,0,39,0,0,0,0.0,0.0,47,0,0.0
commons-math-3.6.1,org.apache.commons.math3.ml.neuralnet.twod.util.SmoothedDataHistogram,1,0,1,0,0,0.0,0.0,15,0,15,0,0,0,0.0,0.0,9,0,0.0
commons-math-3.6.1,org.apache.commons.math3.dfp.DfpField,38,28,10,24,4,73.68,10.53,144,134,10,134,0,0,93.06,0.0,77,40,51.95
commons-math-3.6.1,org.apache.commons.math3.dfp.Dfp,105,100,5,100,0,95.24,0.0,1312,1209,103,1209,0,0,92.15,0.0,974,915,93.94
commons-math-3.6.1,org.apache.commons.math3.dfp.DfpField$RoundingMode,0,0,0,0,0,0.0,0.0,0,0,0,0,0,0,0.0,0.0,0,0,0
commons-math-3.6.1,org.apache.commons.math3.dfp.DfpMath,20,19,1,19,0,95.0,0.0,416,371,45,371,0,0,89.18,0.0,200,144,72.0
commons-math-3.6.1,org.apache.commons.math3.dfp.DfpDec,11,4,7,4,0,36.36,0.0,136,115,21,115,0,0,84.56,0.0,131,107,81.68
commons-math-3.6.1,org.apache.commons.math3.dfp.UnivariateDfpFunction,0,0,0,0,0,0.0,0.0,0,0,0,0,0,0,0.0,0.0,0,0,0
commons-math-3.6.1,org.apache.commons.math3.dfp.BracketingNthOrderBrentSolverDFP,6,5,1,5,0,83.33,0.0,8,6,2,6,0,0,75.0,0.0,6,4,66.67
commons-math-3.6.1,org.apache.commons.math3.genetics.CrossoverPolicy,0,0,0,0,0,0.0,0.0,0,0,0,0,0,0,0.0,0.0,0,0,0
commons-math-3.6.1,org.apache.commons.math3.genetics.Fitness,0,0,0,0,0,0.0,0.0,0,0,0,0,0,0,0.0,0.0,0,0,0
commons-math-3.6.1,org.apache.commons.math3.genetics.RandomKeyMutation,1,1,0,1,0,100.0,0.0,9,7,2,7,0,0,77.78,0.0,2,2,100.0
commons-math-3.6.1,org.apache.commons.math3.genetics.Population,0,0,0,0,0,0.0,0.0,0,0,0,0,0,0,0.0,0.0,0,0,0
commons-math-3.6.1,org.apache.commons.math3.genetics.BinaryChromosome,3,3,0,3,0,100.0,0.0,22,20,2,20,0,0,90.91,0.0,16,14,87.5
commons-math-3.6.1,org.apache.commons.math3.genetics.BinaryMutation,1,1,0,1,0,100.0,0.0,9,7,2,7,0,0,77.78,0.0,3,3,100.0
commons-math-3.6.1,org.apache.commons.math3.genetics.CycleCrossover,3,2,1,2,0,66.67,0.0,37,34,3,34,0,0,91.89,0.0,23,11,47.83
commons-math-3.6.1,org.apache.commons.math3.genetics.FixedElapsedTime,1,1,0,1,0,100.0,0.0,8,6,2,6,0,0,75.0,0.0,6,4,66.67
commons-math-3.6.1,org.apache.commons.math3.genetics.MutationPolicy,0,0,0,0,0,0.0,0.0,0,0,0,0,0,0,0.0,0.0,0,0,0
commons-math-3.6.1,org.apache.commons.math3.genetics.UniformCrossover,3,2,1,2,0,66.67,0.0,21,11,10,11,0,0,52.38,0.0,10,9,90.0
commons-math-3.6.1,org.apache.commons.math3.genetics.NPointCrossover,3,2,1,2,0,66.67,0.0,34,31,3,31,0,0,91.18,0.0,20,18,90.0
commons-math-3.6.1,org.apache.commons.math3.genetics.TournamentSelection,5,2,3,2,0,40.0,0.0,16,11,5,11,0,0,68.75,0.0,8,6,75.0
commons-math-3.6.1,org.apache.commons.math3.genetics.ChromosomePair,3,2,1,2,0,66.67,0.0,5,4,1,4,0,0,80.0,0.0,3,2,66.67
commons-math-3.6.1,org.apache.commons.math3.genetics.PermutationChromosome,0,0,0,0,0,0.0,0.0,0,0,0,0,0,0,0.0,0.0,0,0,0
commons-math-3.6.1,org.apache.commons.math3.genetics.StoppingCondition,0,0,0,0,0,0.0,0.0,0,0,0,0,0,0,0.0,0.0,0,0,0
commons-math-3.6.1,org.apache.commons.math3.genetics.InvalidRepresentationException,0,0,0,0,0,0.0,0.0,0,0,0,0,0,0,0.0,0.0,0,0,0
commons-math-3.6.1,org.apache.commons.math3.genetics.RandomKey,10,9,1,9,0,90.0,0.0,73,66,7,66,0,0,90.41,0.0,38,35,92.11
commons-math-3.6.1,org.apache.commons.math3.genetics.Chromosome,5,4,1,4,0,80.0,0.0,15,14,1,14,0,0,93.33,0.0,7,6,85.71
commons-math-3.6.1,org.apache.commons.math3.genetics.OrderedCrossover,2,2,0,2,0,100.0,0.0,28,28,0,28,0,0,100.0,0.0,16,11,68.75
commons-math-3.6.1,org.apache.commons.math3.genetics.ElitisticListPopulation,3,3,0,3,0,100.0,0.0,14,14,0,14,0,0,100.0,0.0,12,9,75.0
commons-math-3.6.1,org.apache.commons.math3.genetics.OnePointCrossover,2,2,0,2,0,100.0,0.0,16,12,4,12,0,0,75.0,0.0,11,11,100.0
commons-math-3.6.1,org.apache.commons.math3.genetics.AbstractListChromosome,3,3,0,2,1,100.0,33.33,5,5,0,4,1,0,100.0,20.0,3,2,66.67
commons-math-3.6.1,org.apache.commons.math3.genetics.FixedGenerationCount,2,1,1,1,0,50.0,0.0,10,7,3,7,0,0,70.0,0.0,6,4,66.67
commons-math-3.6.1,org.apache.commons.math3.genetics.ListPopulation,11,10,1,10,0,90.91,0.0,47,37,10,37,0,0,78.72,0.0,22,14,63.64
commons-math-3.6.1,org.apache.commons.math3.genetics.SelectionPolicy,0,0,0,0,0,0.0,0.0,0,0,0,0,0,0,0.0,0.0,0,0,0
commons-math-3.6.1,org.apache.commons.math3.genetics.GeneticAlgorithm,10,9,1,8,1,90.0,10.0,42,37,5,37,0,0,88.1,0.0,21,12,57.14
commons-math-3.6.1,org.apache.commons.math3.geometry.Space,0,0,0,0,0,0.0,0.0,0,0,0,0,0,0,0.0,0.0,0,0,0
commons-math-3.6.1,org.apache.commons.math3.geometry.Point,0,0,0,0,0,0.0,0.0,0,0,0,0,0,0,0.0,0.0,0,0,0
commons-math-3.6.1,org.apache.commons.math3.geometry.VectorFormat,8,4,4,4,0,50.0,0.0,48,41,7,41,0,0,85.42,0.0,27,20,74.07
commons-math-3.6.1,org.apache.commons.math3.geometry.Vector,0,0,0,0,0,0.0,0.0,0,0,0,0,0,0,0.0,0.0,0,0,0
commons-math-3.6.1,org.apache.commons.math3.geometry.euclidean.threed.Line,18,15,3,14,1,83.33,5.56,34,27,7,25,2,0,79.41,5.88,42,30,71.43
commons-math-3.6.1,org.apache.commons.math3.geometry.euclidean.threed.PolyhedronsSet$TranslationTransform,3,3,0,3,0,100.0,0.0,8,8,0,8,0,0,100.0,0.0,4,4,100.0
commons-math-3.6.1,org.apache.commons.math3.geometry.euclidean.threed.SphereGenerator,2,2,0,2,0,100.0,0.0,14,14,0,14,0,0,100.0,0.0,18,15,83.33
commons-math-3.6.1,org.apache.commons.math3.geometry.euclidean.threed.Plane,30,25,5,25,0,83.33,0.0,71,53,18,53,0,0,74.65,0.0,116,98,84.48
commons-math-3.6.1,org.apache.commons.math3.geometry.euclidean.threed.Vector3D,40,40,0,40,0,100.0,0.0,107,107,0,107,0,0,100.0,0.0,164,148,90.24
commons-math-3.6.1,org.apache.commons.math3.geometry.euclidean.threed.FieldRotation,41,41,0,41,0,100.0,0.0,367,367,0,367,0,0,100.0,0.0,238,162,68.07
commons-math-3.6.1,org.apache.commons.math3.geometry.euclidean.threed.SphericalCoordinates$DataTransferObject,1,1,0,1,0,100.0,0.0,4,4,0,4,0,0,100.0,0.0,1,1,100.0
commons-math-3.6.1,org.apache.commons.math3.geometry.euclidean.threed.NotARotationMatrixException,0,0,0,0,0,0.0,0.0,0,0,0,0,0,0,0.0,0.0,0,0,0
commons-math-3.6.1,org.apache.commons.math3.geometry.euclidean.threed.PolyhedronsSet$FacetsContributionVisitor,3,3,0,3,0,100.0,0.0,19,16,3,16,0,0,84.21,0.0,14,12,85.71
commons-math-3.6.1,org.apache.commons.math3.geometry.euclidean.threed.CardanEulerSingularityException,0,0,0,0,0,0.0,0.0,0,0,0,0,0,0,0.0,0.0,0,0,0
commons-math-3.6.1,org.apache.commons.math3.geometry.euclidean.threed.SphericalCoordinates,9,9,0,9,0,100.0,0.0,79,79,0,79,0,0,100.0,0.0,197,197,100.0
commons-math-3.6.1,org.apache.commons.math3.geometry.euclidean.threed.SubLine,3,3,0,3,0,100.0,0.0,16,16,0,16,0,0,100.0,0.0,8,8,100.0
commons-math-3.6.1,org.apache.commons.math3.geometry.euclidean.threed.OutlineExtractor$BoundaryProjector,4,0,4,0,0,0.0,0.0,47,0,47,0,0,0,0.0,0.0,37,0,0.0
commons-math-3.6.1,org.apache.commons.math3.geometry.euclidean.threed.Euclidean3D,4,4,0,4,0,100.0,0.0,4,4,0,4,0,0,100.0,0.0,4,4,100.0
commons-math-3.6.1,org.apache.commons.math3.geometry.euclidean.threed.Euclidean3D$LazyHolder,0,0,0,0,0,0.0,0.0,0,0,0,0,0,0,0.0,0.0,0,0,0
commons-math-3.6.1,org.apache.commons.math3.geometry.euclidean.threed.Rotation,24,24,0,23,1,100.0,4.17,421,421,0,421,0,0,100.0,0.0,668,591,88.47
commons-math-3.6.1,org.apache.commons.math3.geometry.euclidean.threed.FieldVector3D,67,67,0,67,0,100.0,0.0,190,190,0,190,0,0,100.0,0.0,162,132,81.48
commons-math-3.6.1,org.apache.commons.math3.geometry.euclidean.threed.RotationOrder,4,4,0,4,0,100.0,0.0,8,4,4,4,0,0,50.0,0.0,4,4,100.0
commons-math-3.6.1,org.apache.commons.math3.geometry.euclidean.threed.PolyhedronsSet,11,11,0,8,3,100.0,27.27,110,99,11,97,2,1,90.0,1.82,94,61,64.89
commons-math-3.6.1,org.apache.commons.math3.geometry.euclidean.threed.OutlineExtractor,2,0,2,0,0,0.0,0.0,23,0,23,0,0,0,0.0,0.0,42,0,0.0
commons-math-3.6.1,org.apache.commons.math3.geometry.euclidean.threed.Segment,3,3,0,3,0,100.0,0.0,6,6,0,6,0,0,100.0,0.0,3,3,100.0
commons-math-3.6.1,org.apache.commons.math3.geometry.euclidean.threed.PolyhedronsSet$RotationTransform,3,3,0,3,0,100.0,0.0,9,9,0,9,0,0,100.0,0.0,8,8,100.0
commons-math-3.6.1,org.apache.commons.math3.geometry.euclidean.threed.Vector3DFormat,5,5,0,5,0,100.0,0.0,13,11,2,11,0,0,84.62,0.0,7,7,100.0
commons-math-3.6.1,org.apache.commons.math3.geometry.euclidean.threed.SubPlane,2,2,0,2,0,100.0,0.0,18,18,0,18,0,0,100.0,0.0,15,12,80.0
commons-math-3.6.1,org.apache.commons.math3.geometry.euclidean.threed.RotationConvention,0,0,0,0,0,0.0,0.0,0,0,0,0,0,0,0.0,0.0,0,0,0
commons-math-3.6.1,org.apache.commons.math3.geometry.euclidean.oned.Vector1D,29,28,1,28,0,96.55,0.0,58,56,2,53,3,2,96.55,5.17,60,55,91.67
commons-math-3.6.1,org.apache.commons.math3.geometry.euclidean.oned.Vector1DFormat,5,5,0,5,0,100.0,0.0,13,11,2,11,0,0,84.62,0.0,7,7,100.0
commons-math-3.6.1,org.apache.commons.math3.geometry.euclidean.oned.Euclidean1D,4,4,0,3,1,100.0,25.0,4,4,0,3,1,0,100.0,25.0,3,3,100.0
commons-math-3.6.1,org.apache.commons.math3.geometry.euclidean.oned.OrientedPoint,11,6,5,6,0,54.55,0.0,14,9,5,9,0,0,64.29,0.0,17,12,70.59
commons-math-3.6.1,org.apache.commons.math3.geometry.euclidean.oned.Euclidean1D$NoSubSpaceException,0,0,0,0,0,0.0,0.0,0,0,0,0,0,0,0.0,0.0,0,0,0
commons-math-3.6.1,org.apache.commons.math3.geometry.euclidean.oned.IntervalsSet$SubIntervalsIterator,4,3,1,3,0,75.0,0.0,37,34,3,34,0,0,91.89,0.0,11,7,63.64
commons-math-3.6.1,org.apache.commons.math3.geometry.euclidean.oned.SubOrientedPoint,4,3,1,2,1,75.0,25.0,10,9,1,9,0,0,90.0,0.0,9,7,77.78
commons-math-3.6.1,org.apache.commons.math3.geometry.euclidean.oned.Interval,9,5,4,5,0,55.56,0.0,20,16,4,16,0,0,80.0,0.0,26,18,69.23
commons-math-3.6.1,org.apache.commons.math3.geometry.euclidean.oned.Euclidean1D$LazyHolder,0,0,0,0,0,0.0,0.0,0,0,0,0,0,0,0.0,0.0,0,0,0
commons-math-3.6.1,org.apache.commons.math3.geometry.euclidean.oned.IntervalsSet,23,23,0,23,0,100.0,0.0,136,124,12,124,0,0,91.18,0.0,107,72,67.29
commons-math-3.6.1,org.apache.commons.math3.geometry.euclidean.twod.Line,30,25,5,24,1,83.33,3.33,84,60,24,60,0,0,71.43,0.0,79,52,65.82
commons-math-3.6.1,org.apache.commons.math3.geometry.euclidean.twod.Euclidean2D,4,4,0,4,0,100.0,0.0,4,4,0,4,0,0,100.0,0.0,4,4,100.0
commons-math-3.6.1,org.apache.commons.math3.geometry.euclidean.twod.PolygonsSet$Edge,6,6,0,4,2,100.0,33.33,15,15,0,15,0,0,100.0,0.0,6,4,66.67
commons-math-3.6.1,org.apache.commons.math3.geometry.euclidean.twod.NestedLoops,4,0,4,0,0,0.0,0.0,49,0,49,0,0,0,0.0,0.0,15,0,0.0
commons-math-3.6.1,org.apache.commons.math3.geometry.euclidean.twod.PolygonsSet$SegmentsBuilder,5,5,0,5,0,100.0,0.0,23,23,0,23,0,0,100.0,0.0,13,11,84.62
commons-math-3.6.1,org.apache.commons.math3.geometry.euclidean.twod.Euclidean2D$LazyHolder,0,0,0,0,0,0.0,0.0,0,0,0,0,0,0,0.0,0.0,0,0,0
commons-math-3.6.1,org.apache.commons.math3.geometry.euclidean.twod.Vector2D,33,13,20,9,4,39.39,12.12,84,37,47,37,0,0,44.05,0.0,114,32,28.07
commons-math-3.6.1,org.apache.commons.math3.geometry.euclidean.twod.DiskGenerator,2,2,0,2,0,100.0,0.0,11,11,0,11,0,0,100.0,0.0,12,12,100.0
commons-math-3.6.1,org.apache.commons.math3.geometry.euclidean.twod.SubLine,5,5,0,5,0,100.0,0.0,27,27,0,27,0,0,100.0,0.0,25,22,88.0
commons-math-3.6.1,org.apache.commons.math3.geometry.euclidean.twod.PolygonsSet,12,12,0,10,2,100.0,16.67,235,188,47,186,2,1,80.0,0.85,178,99,55.62
commons-math-3.6.1,org.apache.commons.math3.geometry.euclidean.twod.Vector2DFormat,5,4,1,4,0,80.0,0.0,13,10,3,10,0,0,76.92,0.0,7,6,85.71
commons-math-3.6.1,org.apache.commons.math3.geometry.euclidean.twod.Line$LineTransform,3,3,0,3,0,100.0,0.0,15,13,2,13,0,0,86.67,0.0,13,12,92.31
commons-math-3.6.1,org.apache.commons.math3.geometry.euclidean.twod.PolygonsSet$ConnectableSegment,9,9,0,7,2,100.0,22.22,15,15,0,15,0,0,100.0,0.0,7,2,28.57
commons-math-3.6.1,org.apache.commons.math3.geometry.euclidean.twod.Segment,4,4,0,4,0,100.0,0.0,10,8,2,8,0,0,80.0,0.0,24,21,87.5
commons-math-3.6.1,org.apache.commons.math3.geometry.euclidean.twod.PolygonsSet$Vertex,7,7,0,5,2,100.0,28.57,18,18,0,18,0,0,100.0,0.0,7,4,57.14
commons-math-3.6.1,org.apache.commons.math3.geometry.euclidean.twod.hull.ConvexHullGenerator2D,0,0,0,0,0,0.0,0.0,0,0,0,0,0,0,0.0,0.0,0,0,0
commons-math-3.6.1,org.apache.commons.math3.geometry.euclidean.twod.hull.MonotoneChain,3,3,0,3,0,100.0,0.0,45,45,0,45,0,0,100.0,0.0,41,32,78.05
commons-math-3.6.1,org.apache.commons.math3.geometry.euclidean.twod.hull.ConvexHull2D,5,5,0,5,0,100.0,0.0,49,47,2,47,0,0,95.92,0.0,31,30,96.77
commons-math-3.6.1,org.apache.commons.math3.geometry.euclidean.twod.hull.AklToussaintHeuristic,3,3,0,1,2,100.0,66.67,52,48,4,48,0,0,92.31,0.0,39,15,38.46
commons-math-3.6.1,org.apache.commons.math3.geometry.euclidean.twod.hull.AbstractConvexHullGenerator2D,3,3,0,3,0,100.0,0.0,13,13,0,13,0,0,100.0,0.0,7,6,85.71
commons-math-3.6.1,org.apache.commons.math3.geometry.hull.ConvexHull,0,0,0,0,0,0.0,0.0,0,0,0,0,0,0,0.0,0.0,0,0,0
commons-math-3.6.1,org.apache.commons.math3.geometry.hull.ConvexHullGenerator,0,0,0,0,0,0.0,0.0,0,0,0,0,0,0,0.0,0.0,0,0,0
commons-math-3.6.1,org.apache.commons.math3.geometry.spherical.oned.SubLimitAngle,4,4,0,2,2,100.0,50.0,4,4,0,4,0,0,100.0,0.0,5,4,80.0
commons-math-3.6.1,org.apache.commons.math3.geometry.spherical.oned.ArcsSet$InconsistentStateAt2PiWrapping,0,0,0,0,0,0.0,0.0,0,0,0,0,0,0,0.0,0.0,0,0,0
commons-math-3.6.1,org.apache.commons.math3.geometry.spherical.oned.ArcsSet$Split,3,3,0,3,0,100.0,0.0,14,14,0,14,0,0,100.0,0.0,9,9,100.0
commons-math-3.6.1,org.apache.commons.math3.geometry.spherical.oned.LimitAngle,10,9,1,8,1,90.0,10.0,13,12,1,12,0,0,92.31,0.0,17,15,88.24
commons-math-3.6.1,org.apache.commons.math3.geometry.spherical.oned.Sphere1D$NoSubSpaceException,0,0,0,0,0,0.0,0.0,0,0,0,0,0,0,0.0,0.0,0,0,0
commons-math-3.6.1,org.apache.commons.math3.geometry.spherical.oned.Sphere1D$LazyHolder,0,0,0,0,0,0.0,0.0,0,0,0,0,0,0,0.0,0.0,0,0,0
commons-math-3.6.1,org.apache.commons.math3.geometry.spherical.oned.Arc,6,5,1,5,0,83.33,0.0,24,23,1,23,0,0,95.83,0.0,24,18,75.0
commons-math-3.6.1,org.apache.commons.math3.geometry.spherical.oned.Sphere1D,4,4,0,3,1,100.0,25.0,4,4,0,3,1,0,100.0,25.0,3,3,100.0
commons-math-3.6.1,org.apache.commons.math3.geometry.spherical.oned.S1Point,8,8,0,7,1,100.0,12.5,22,20,2,20,0,0,90.91,0.0,20,15,75.0
commons-math-3.6.1,org.apache.commons.math3.geometry.spherical.oned.ArcsSet$SubArcsIterator,4,4,0,4,0,100.0,0.0,42,40,2,40,0,0,95.24,0.0,15,11,73.33
commons-math-3.6.1,org.apache.commons.math3.geometry.spherical.oned.ArcsSet,26,25,1,25,0,96.15,0.0,224,201,23,201,0,0,89.73,0.0,179,110,61.45
commons-math-3.6.1,org.apache.commons.math3.geometry.spherical.twod.S2Point,11,11,0,10,1,100.0,9.09,29,27,2,27,0,0,93.1,0.0,35,25,71.43
commons-math-3.6.1,org.apache.commons.math3.geometry.spherical.twod.EdgesBuilder,5,5,0,5,0,100.0,0.0,41,40,1,40,0,0,97.56,0.0,19,15,78.95
commons-math-3.6.1,org.apache.commons.math3.geometry.spherical.twod.Edge,8,8,0,8,0,100.0,0.0,43,40,3,40,0,0,93.02,0.0,38,18,47.37
commons-math-3.6.1,org.apache.commons.math3.geometry.spherical.twod.Circle$CircleTransform,3,3,0,3,0,100.0,0.0,4,4,0,4,0,0,100.0,0.0,3,3,100.0
commons-math-3.6.1,org.apache.commons.math3.geometry.spherical.twod.SphericalPolygonsSet,9,9,0,9,0,100.0,0.0,122,112,10,112,0,0,91.8,0.0,91,69,75.82
commons-math-3.6.1,org.apache.commons.math3.geometry.spherical.twod.PropertiesComputer,7,7,0,7,0,100.0,0.0,37,31,6,31,0,0,83.78,0.0,25,20,80.0
commons-math-3.6.1,org.apache.commons.math3.geometry.spherical.twod.Circle,20,19,1,19,0,95.0,0.0,31,30,1,30,0,0,96.77,0.0,26,24,92.31
commons-math-3.6.1,org.apache.commons.math3.geometry.spherical.twod.Vertex,7,7,0,5,2,100.0,28.57,18,16,2,16,0,0,88.89,0.0,7,4,57.14
commons-math-3.6.1,org.apache.commons.math3.geometry.spherical.twod.Sphere2D$LazyHolder,0,0,0,0,0,0.0,0.0,0,0,0,0,0,0,0.0,0.0,0,0,0
commons-math-3.6.1,org.apache.commons.math3.geometry.spherical.twod.SubCircle,2,2,0,2,0,100.0,0.0,5,5,0,5,0,0,100.0,0.0,10,8,80.0
commons-math-3.6.1,org.apache.commons.math3.geometry.spherical.twod.Sphere2D,4,3,1,3,0,75.0,0.0,4,3,1,3,0,0,75.0,0.0,4,3,75.0
commons-math-3.6.1,org.apache.commons.math3.geometry.enclosing.Encloser,0,0,0,0,0,0.0,0.0,0,0,0,0,0,0,0.0,0.0,0,0,0
commons-math-3.6.1,org.apache.commons.math3.geometry.enclosing.WelzlEncloser,4,4,0,4,0,100.0,0.0,45,43,2,43,0,0,95.56,0.0,26,17,65.38
commons-math-3.6.1,org.apache.commons.math3.geometry.enclosing.EnclosingBall,6,6,0,6,0,100.0,0.0,9,9,0,9,0,0,100.0,0.0,11,10,90.91
commons-math-3.6.1,org.apache.commons.math3.geometry.enclosing.SupportBallGenerator,0,0,0,0,0,0.0,0.0,0,0,0,0,0,0,0.0,0.0,0,0,0
commons-math-3.6.1,org.apache.commons.math3.geometry.partitioning.BoundaryBuilder,2,2,0,2,0,100.0,0.0,28,28,0,28,0,0,100.0,0.0,14,13,92.86
commons-math-3.6.1,org.apache.commons.math3.geometry.partitioning.SubHyperplane,0,0,0,0,0,0.0,0.0,0,0,0,0,0,0,0.0,0.0,0,0,0
commons-math-3.6.1,org.apache.commons.math3.geometry.partitioning.RegionFactory$VanishingToLeaf,1,0,1,0,0,0.0,0.0,5,1,4,1,0,0,20.0,0.0,3,0,0.0
commons-math-3.6.1,org.apache.commons.math3.geometry.partitioning.Region$Location,0,0,0,0,0,0.0,0.0,0,0,0,0,0,0,0.0,0.0,0,0,0
commons-math-3.6.1,org.apache.commons.math3.geometry.partitioning.BSPTree$VanishingCutHandler,0,0,0,0,0,0.0,0.0,0,0,0,0,0,0,0.0,0.0,0,0,0
commons-math-3.6.1,org.apache.commons.math3.geometry.partitioning.BoundaryAttribute,3,3,0,3,0,100.0,0.0,6,6,0,6,0,0,100.0,0.0,3,3,100.0
commons-math-3.6.1,org.apache.commons.math3.geometry.partitioning.Embedding,0,0,0,0,0,0.0,0.0,0,0,0,0,0,0,0.0,0.0,0,0,0
commons-math-3.6.1,org.apache.commons.math3.geometry.partitioning.BSPTree$LeafMerger,0,0,0,0,0,0.0,0.0,0,0,0,0,0,0,0.0,0.0,0,0,0
commons-math-3.6.1,org.apache.commons.math3.geometry.partitioning.RegionFactory$UnionMerger,1,1,0,1,0,100.0,0.0,6,6,0,6,0,0,100.0,0.0,5,4,80.0
commons-math-3.6.1,org.apache.commons.math3.geometry.partitioning.Hyperplane,0,0,0,0,0,0.0,0.0,0,0,0,0,0,0,0.0,0.0,0,0,0
commons-math-3.6.1,org.apache.commons.math3.geometry.partitioning.BSPTreeVisitor,0,0,0,0,0,0.0,0.0,0,0,0,0,0,0,0.0,0.0,0,0,0
commons-math-3.6.1,org.apache.commons.math3.geometry.partitioning.BSPTreeVisitor$Order,0,0,0,0,0,0.0,0.0,0,0,0,0,0,0,0.0,0.0,0,0,0
commons-math-3.6.1,org.apache.commons.math3.geometry.partitioning.RegionFactory$NodesCleaner,2,2,0,1,1,100.0,50.0,2,2,0,2,0,0,100.0,0.0,2,1,50.0
commons-math-3.6.1,org.apache.commons.math3.geometry.partitioning.BoundarySizeVisitor,3,3,0,3,0,100.0,0.0,9,9,0,9,0,0,100.0,0.0,6,6,100.0
commons-math-3.6.1,org.apache.commons.math3.geometry.partitioning.RegionFactory,8,8,0,8,0,100.0,0.0,53,51,2,51,0,0,96.23,0.0,31,26,83.87
commons-math-3.6.1,org.apache.commons.math3.geometry.partitioning.Side,0,0,0,0,0,0.0,0.0,0,0,0,0,0,0,0.0,0.0,0,0,0
commons-math-3.6.1,org.apache.commons.math3.geometry.partitioning.AbstractSubHyperplane,9,8,1,8,0,88.89,0.0,30,29,1,29,0,0,96.67,0.0,17,16,94.12
commons-math-3.6.1,org.apache.commons.math3.geometry.partitioning.BSPTree,24,21,3,18,3,87.5,12.5,224,200,24,200,0,0,89.29,0.0,116,82,70.69
commons-math-3.6.1,org.apache.commons.math3.geometry.partitioning.Characterization,9,9,0,9,0,100.0,0.0,38,37,1,37,0,0,97.37,0.0,23,23,100.0
commons-math-3.6.1,org.apache.commons.math3.geometry.partitioning.AbstractRegion,28,25,3,24,1,89.29,3.57,135,124,11,122,2,0,91.85,1.48,79,67,84.81
commons-math-3.6.1,org.apache.commons.math3.geometry.partitioning.NodesSet,3,3,0,3,0,100.0,0.0,9,9,0,9,0,0,100.0,0.0,3,3,100.0
commons-math-3.6.1,org.apache.commons.math3.geometry.partitioning.SubHyperplane$SplitSubHyperplane,3,3,0,3,0,100.0,0.0,14,14,0,14,0,0,100.0,0.0,12,12,100.0
commons-math-3.6.1,org.apache.commons.math3.geometry.partitioning.RegionFactory$DifferenceMerger,2,2,0,2,0,100.0,0.0,9,9,0,9,0,0,100.0,0.0,10,6,60.0
commons-math-3.6.1,org.apache.commons.math3.geometry.partitioning.RegionFactory$XorMerger,1,1,0,1,0,100.0,0.0,6,6,0,6,0,0,100.0,0.0,3,2,66.67
commons-math-3.6.1,org.apache.commons.math3.geometry.partitioning.Transform,0,0,0,0,0,0.0,0.0,0,0,0,0,0,0,0.0,0.0,0,0,0
commons-math-3.6.1,org.apache.commons.math3.geometry.partitioning.Region,0,0,0,0,0,0.0,0.0,0,0,0,0,0,0,0.0,0.0,0,0,0
commons-math-3.6.1,org.apache.commons.math3.geometry.partitioning.BoundaryProjector,8,8,0,8,0,100.0,0.0,41,41,0,41,0,0,100.0,0.0,24,21,87.5
commons-math-3.6.1,org.apache.commons.math3.geometry.partitioning.RegionFactory$IntersectionMerger,1,1,0,1,0,100.0,0.0,6,6,0,6,0,0,100.0,0.0,5,3,60.0
commons-math-3.6.1,org.apache.commons.math3.geometry.partitioning.BoundaryProjection,3,3,0,3,0,100.0,0.0,6,6,0,6,0,0,100.0,0.0,3,3,100.0
commons-math-3.6.1,org.apache.commons.math3.geometry.partitioning.InsideFinder,3,0,3,0,0,0.0,0.0,56,0,56,0,0,0,0.0,0.0,31,0,0.0
commons-math-3.6.1,org.apache.commons.math3.geometry.partitioning.utilities.OrderedTuple,11,0,11,0,0,0.0,0.0,141,0,141,0,0,0,0.0,0.0,122,0,0.0
commons-math-3.6.1,org.apache.commons.math3.geometry.partitioning.utilities.AVLTree,8,7,1,7,0,87.5,0.0,53,49,4,49,0,0,92.45,0.0,31,25,80.65
commons-math-3.6.1,org.apache.commons.math3.geometry.partitioning.utilities.AVLTree$Node,14,14,0,14,0,100.0,0.0,210,210,0,210,0,0,100.0,0.0,90,69,76.67
commons-math-3.6.1,org.apache.commons.math3.geometry.partitioning.utilities.AVLTree$Skew,0,0,0,0,0,0.0,0.0,0,0,0,0,0,0,0.0,0.0,0,0,0
commons-math-3.6.1,org.apache.commons.math3.filter.DefaultMeasurementModel,2,2,0,2,0,100.0,0.0,4,4,0,4,0,0,100.0,0.0,2,2,100.0
commons-math-3.6.1,org.apache.commons.math3.filter.DefaultProcessModel,5,5,0,5,0,100.0,0.0,10,10,0,10,0,0,100.0,0.0,5,5,100.0
commons-math-3.6.1,org.apache.commons.math3.filter.KalmanFilter,11,8,3,6,2,72.73,18.18,69,54,15,54,0,0,78.26,0.0,14,9,64.29
commons-math-3.6.1,org.apache.commons.math3.filter.MeasurementModel,0,0,0,0,0,0.0,0.0,0,0,0,0,0,0,0.0,0.0,0,0,0
commons-math-3.6.1,org.apache.commons.math3.filter.ProcessModel,0,0,0,0,0,0.0,0.0,0,0,0,0,0,0,0.0,0.0,0,0,0
commons-math-3.6.1,org.apache.commons.math3.random.UnitSphereRandomVectorGenerator,1,1,0,1,0,100.0,0.0,11,11,0,11,0,0,100.0,0.0,9,9,100.0
commons-math-3.6.1,org.apache.commons.math3.random.MersenneTwister,4,4,0,4,0,100.0,0.0,75,72,3,72,0,0,96.0,0.0,106,98,92.45
commons-math-3.6.1,org.apache.commons.math3.random.SobolSequenceGenerator,5,5,0,5,0,100.0,0.0,94,84,10,84,0,0,89.36,0.0,73,61,83.56
commons-math-3.6.1,org.apache.commons.math3.random.EmpiricalDistribution,31,27,4,20,7,87.1,22.58,128,113,15,113,0,0,88.28,0.0,120,93,77.5
commons-math-3.6.1,org.apache.commons.math3.random.RandomDataImpl,32,1,31,0,1,3.12,3.12,34,2,32,2,0,0,5.88,0.0,32,0,0.0
commons-math-3.6.1,org.apache.commons.math3.random.AbstractWell,3,3,0,3,0,100.0,0.0,29,29,0,29,0,0,100.0,0.0,19,15,78.95
commons-math-3.6.1,org.apache.commons.math3.random.RandomGeneratorFactory,13,11,2,11,0,84.62,0.0,19,14,5,14,0,0,73.68,0.0,4,1,25.0
commons-math-3.6.1,org.apache.commons.math3.random.RandomAdaptor,12,10,2,1,9,83.33,75.0,20,13,7,2,11,0,65.0,55.0,16,3,18.75
commons-math-3.6.1,org.apache.commons.math3.random.StableRandomGenerator,1,1,0,1,0,100.0,0.0,39,31,8,31,0,0,79.49,0.0,48,13,27.08
commons-math-3.6.1,org.apache.commons.math3.random.JDKRandomGenerator,2,1,1,1,0,50.0,0.0,3,2,1,2,0,0,66.67,0.0,2,1,50.0
commons-math-3.6.1,org.apache.commons.math3.random.Well512a,1,1,0,1,0,100.0,0.0,4,4,0,4,0,0,100.0,0.0,22,22,100.0
commons-math-3.6.1,org.apache.commons.math3.random.AbstractRandomGenerator,10,9,1,9,0,90.0,0.0,46,42,4,42,0,0,91.3,0.0,49,31,63.27
commons-math-3.6.1,org.apache.commons.math3.random.RandomDataGenerator,33,31,2,27,4,93.94,12.12,157,127,30,127,0,0,80.89,0.0,134,70,52.24
commons-math-3.6.1,org.apache.commons.math3.random.RandomVectorGenerator,0,0,0,0,0,0.0,0.0,0,0,0,0,0,0,0.0,0.0,0,0,0
commons-math-3.6.1,org.apache.commons.math3.random.RandomData,0,0,0,0,0,0.0,0.0,0,0,0,0,0,0,0.0,0.0,0,0,0
commons-math-3.6.1,org.apache.commons.math3.random.EmpiricalDistribution$ArrayDataAdapter,2,2,0,2,0,100.0,0.0,10,10,0,10,0,0,100.0,0.0,6,6,100.0
commons-math-3.6.1,org.apache.commons.math3.random.Well44497b,1,1,0,1,0,100.0,0.0,8,8,0,8,0,0,100.0,0.0,35,35,100.0
commons-math-3.6.1,org.apache.commons.math3.random.HaltonSequenceGenerator,4,4,0,4,0,100.0,0.0,27,27,0,27,0,0,100.0,0.0,18,16,88.89
commons-math-3.6.1,org.apache.commons.math3.random.ValueServer,23,23,0,17,6,100.0,26.09,64,59,5,59,0,0,92.19,0.0,37,28,75.68
commons-math-3.6.1,org.apache.commons.math3.random.EmpiricalDistribution$StreamDataAdapter,2,2,0,2,0,100.0,0.0,19,19,0,19,0,0,100.0,0.0,6,4,66.67
commons-math-3.6.1,org.apache.commons.math3.random.Well19937c,1,1,0,1,0,100.0,0.0,8,8,0,8,0,0,100.0,0.0,32,32,100.0
commons-math-3.6.1,org.apache.commons.math3.random.UncorrelatedRandomVectorGenerator,1,1,0,1,0,100.0,0.0,15,13,2,13,0,0,86.67,0.0,5,5,100.0
commons-math-3.6.1,org.apache.commons.math3.random.BitsStreamGenerator,12,10,2,10,0,83.33,0.0,59,43,16,43,0,0,72.88,0.0,76,42,55.26
commons-math-3.6.1,org.apache.commons.math3.random.SynchronizedRandomGenerator,11,8,3,8,0,72.73,0.0,12,9,3,9,0,0,75.0,0.0,12,9,75.0
commons-math-3.6.1,org.apache.commons.math3.random.Well44497a,1,1,0,1,0,100.0,0.0,5,5,0,5,0,0,100.0,0.0,29,29,100.0
commons-math-3.6.1,org.apache.commons.math3.random.UniformRandomGenerator,1,1,0,1,0,100.0,0.0,2,2,0,2,0,0,100.0,0.0,4,4,100.0
commons-math-3.6.1,org.apache.commons.math3.random.Well1024a,1,1,0,1,0,100.0,0.0,4,4,0,4,0,0,100.0,0.0,20,20,100.0
commons-math-3.6.1,org.apache.commons.math3.random.Well19937a,1,1,0,1,0,100.0,0.0,5,5,0,5,0,0,100.0,0.0,26,26,100.0
commons-math-3.6.1,org.apache.commons.math3.random.CorrelatedRandomVectorGenerator,4,3,1,3,0,75.0,0.0,30,19,11,19,0,0,63.33,0.0,12,10,83.33
commons-math-3.6.1,org.apache.commons.math3.random.EmpiricalDistribution$DataAdapter,0,0,0,0,0,0.0,0.0,0,0,0,0,0,0,0.0,0.0,0,0,0
commons-math-3.6.1,org.apache.commons.math3.random.ISAACRandom,10,10,0,10,0,100.0,0.0,119,115,4,115,0,0,96.64,0.0,147,138,93.88
commons-math-3.6.1,org.apache.commons.math3.random.RandomGenerator,0,0,0,0,0,0.0,0.0,0,0,0,0,0,0,0.0,0.0,0,0,0
commons-math-3.6.1,org.apache.commons.math3.random.GaussianRandomGenerator,1,1,0,1,0,100.0,0.0,2,2,0,2,0,0,100.0,0.0,1,1,100.0
commons-math-3.6.1,org.apache.commons.math3.random.NormalizedRandomGenerator,0,0,0,0,0,0.0,0.0,0,0,0,0,0,0,0.0,0.0,0,0,0
commons-math-3.6.1,org.apache.commons.math3.fraction.ProperBigFractionFormat,4,4,0,4,0,100.0,0.0,67,58,9,58,0,0,86.57,0.0,33,21,63.64
commons-math-3.6.1,org.apache.commons.math3.fraction.FractionConversionException,0,0,0,0,0,0.0,0.0,0,0,0,0,0,0,0.0,0.0,0,0,0
commons-math-3.6.1,org.apache.commons.math3.fraction.ProperFractionFormat,4,4,0,4,0,100.0,0.0,64,55,9,55,0,0,85.94,0.0,32,21,65.62
commons-math-3.6.1,org.apache.commons.math3.fraction.BigFractionField,5,5,0,5,0,100.0,0.0,5,5,0,5,0,0,100.0,0.0,5,5,100.0
commons-math-3.6.1,org.apache.commons.math3.fraction.BigFractionField$LazyHolder,0,0,0,0,0,0.0,0.0,0,0,0,0,0,0,0.0,0.0,0,0,0
commons-math-3.6.1,org.apache.commons.math3.fraction.FractionField,5,5,0,5,0,100.0,0.0,5,5,0,5,0,0,100.0,0.0,5,5,100.0
commons-math-3.6.1,org.apache.commons.math3.fraction.FractionFormat,11,6,5,6,0,54.55,0.0,43,37,6,37,0,0,86.05,0.0,25,15,60.0
commons-math-3.6.1,org.apache.commons.math3.fraction.AbstractFormat,10,9,1,9,0,90.0,0.0,32,27,5,25,2,2,84.38,6.25,22,17,77.27
commons-math-3.6.1,org.apache.commons.math3.fraction.BigFraction,44,41,3,40,1,93.18,2.27,294,251,43,251,0,0,85.37,0.0,144,114,79.17
commons-math-3.6.1,org.apache.commons.math3.fraction.Fraction,25,25,0,25,0,100.0,0.0,178,171,7,171,0,0,96.07,0.0,94,87,92.55
commons-math-3.6.1,org.apache.commons.math3.fraction.BigFractionFormat,11,7,4,7,0,63.64,0.0,54,47,7,47,0,0,87.04,0.0,33,23,69.7
commons-math-3.6.1,org.apache.commons.math3.fraction.FractionField$LazyHolder,0,0,0,0,0,0.0,0.0,0,0,0,0,0,0,0.0,0.0,0,0,0
commons-math-3.6.1,org.apache.commons.math3.exception.MathInternalError,0,0,0,0,0,0.0,0.0,1,0,1,0,0,0,0.0,0.0,0,0,0
commons-math-3.6.1,org.apache.commons.math3.exception.ConvergenceException,0,0,0,0,0,0.0,0.0,1,1,0,1,0,0,100.0,0.0,0,0,0
commons-math-3.6.1,org.apache.commons.math3.exception.NumberIsTooSmallException,2,2,0,2,0,100.0,0.0,4,4,0,4,0,0,100.0,0.0,3,3,100.0
commons-math-3.6.1,org.apache.commons.math3.exception.MaxCountExceededException,1,1,0,1,0,100.0,0.0,3,3,0,3,0,0,100.0,0.0,1,1,100.0
commons-math-3.6.1,org.apache.commons.math3.exception.NotPositiveException,0,0,0,0,0,0.0,0.0,0,0,0,0,0,0,0.0,0.0,0,0,0
commons-math-3.6.1,org.apache.commons.math3.exception.MathIllegalNumberException,1,1,0,1,0,100.0,0.0,2,2,0,2,0,0,100.0,0.0,1,1,100.0
commons-math-3.6.1,org.apache.commons.math3.exception.NoDataException,0,0,0,0,0,0.0,0.0,0,0,0,0,0,0,0.0,0.0,0,0,0
commons-math-3.6.1,org.apache.commons.math3.exception.MathParseException,0,0,0,0,0,0.0,0.0,2,1,1,1,0,0,50.0,0.0,0,0,0
commons-math-3.6.1,org.apache.commons.math3.exception.MathRuntimeException,3,0,3,0,0,0.0,0.0,5,0,5,0,0,0,0.0,0.0,3,0,0.0
commons-math-3.6.1,org.apache.commons.math3.exception.MathIllegalArgumentException,3,2,1,2,0,66.67,0.0,5,4,1,4,0,0,80.0,0.0,3,2,66.67
commons-math-3.6.1,org.apache.commons.math3.exception.DimensionMismatchException,1,1,0,1,0,100.0,0.0,2,2,0,2,0,0,100.0,0.0,1,1,100.0
commons-math-3.6.1,org.apache.commons.math3.exception.ZeroException,0,0,0,0,0,0.0,0.0,0,0,0,0,0,0,0.0,0.0,0,0,0
commons-math-3.6.1,org.apache.commons.math3.exception.NotStrictlyPositiveException,0,0,0,0,0,0.0,0.0,0,0,0,0,0,0,0.0,0.0,0,0,0
commons-math-3.6.1,org.apache.commons.math3.exception.NonMonotonicSequenceException,4,4,0,3,1,100.0,25.0,8,8,0,7,1,0,100.0,12.5,5,5,100.0
commons-math-3.6.1,org.apache.commons.math3.exception.MathUnsupportedOperationException,3,0,3,0,0,0.0,0.0,5,2,3,2,0,0,40.0,0.0,3,0,0.0
commons-math-3.6.1,org.apache.commons.math3.exception.MathIllegalStateException,3,2,1,2,0,66.67,0.0,7,4,3,4,0,0,57.14,0.0,3,2,66.67
commons-math-3.6.1,org.apache.commons.math3.exception.NumberIsTooLargeException,2,2,0,1,1,100.0,50.0,4,4,0,3,1,0,100.0,25.0,3,2,66.67
commons-math-3.6.1,org.apache.commons.math3.exception.NullArgumentException,0,0,0,0,0,0.0,0.0,0,0,0,0,0,0,0.0,0.0,0,0,0
commons-math-3.6.1,org.apache.commons.math3.exception.TooManyIterationsException,0,0,0,0,0,0.0,0.0,1,1,0,1,0,0,100.0,0.0,0,0,0
commons-math-3.6.1,org.apache.commons.math3.exception.OutOfRangeException,2,2,0,2,0,100.0,0.0,4,4,0,4,0,0,100.0,0.0,2,2,100.0
commons-math-3.6.1,org.apache.commons.math3.exception.MultiDimensionMismatchException,4,2,2,2,0,50.0,0.0,6,4,2,4,0,0,66.67,0.0,4,2,50.0
commons-math-3.6.1,org.apache.commons.math3.exception.NotANumberException,0,0,0,0,0,0.0,0.0,0,0,0,0,0,0,0.0,0.0,0,0,0
commons-math-3.6.1,org.apache.commons.math3.exception.TooManyEvaluationsException,0,0,0,0,0,0.0,0.0,1,1,0,1,0,0,100.0,0.0,0,0,0
commons-math-3.6.1,org.apache.commons.math3.exception.InsufficientDataException,0,0,0,0,0,0.0,0.0,0,0,0,0,0,0,0.0,0.0,0,0,0
commons-math-3.6.1,org.apache.commons.math3.exception.MathArithmeticException,3,2,1,2,0,66.67,0.0,7,6,1,6,0,0,85.71,0.0,3,2,66.67
commons-math-3.6.1,org.apache.commons.math3.exception.NoBracketingException,4,0,4,0,0,0.0,0.0,8,4,4,4,0,0,50.0,0.0,4,0,0.0
commons-math-3.6.1,org.apache.commons.math3.exception.NotFiniteNumberException,0,0,0,0,0,0.0,0.0,0,0,0,0,0,0,0.0,0.0,0,0,0
commons-math-3.6.1,org.apache.commons.math3.exception.util.LocalizedFormats,2,2,0,2,0,100.0,0.0,8,8,0,8,0,0,100.0,0.0,4,3,75.0
commons-math-3.6.1,org.apache.commons.math3.exception.util.Localizable,0,0,0,0,0,0.0,0.0,0,0,0,0,0,0,0.0,0.0,0,0,0
commons-math-3.6.1,org.apache.commons.math3.exception.util.DummyLocalizable,3,0,3,0,0,0.0,0.0,4,0,4,0,0,0,0.0,0.0,3,0,0.0
commons-math-3.6.1,org.apache.commons.math3.exception.util.ArgUtils,1,1,0,1,0,100.0,0.0,9,9,0,9,0,0,100.0,0.0,3,3,100.0
commons-math-3.6.1,org.apache.commons.math3.exception.util.ExceptionContext,17,16,1,16,0,94.12,0.0,60,59,1,57,2,1,98.33,3.33,40,39,97.5
commons-math-3.6.1,org.apache.commons.math3.exception.util.ExceptionContextProvider,0,0,0,0,0,0.0,0.0,0,0,0,0,0,0,0.0,0.0,0,0,0
commons-math-3.6.1,org.apache.commons.math3.transform.FastHadamardTransformer,5,4,1,2,2,80.0,40.0,38,35,3,35,0,0,92.11,0.0,42,39,92.86
commons-math-3.6.1,org.apache.commons.math3.transform.DstNormalization,0,0,0,0,0,0.0,0.0,0,0,0,0,0,0,0.0,0.0,0,0,0
commons-math-3.6.1,org.apache.commons.math3.transform.TransformUtils,5,4,1,4,0,80.0,0.0,28,19,9,19,0,0,67.86,0.0,20,16,80.0
commons-math-3.6.1,org.apache.commons.math3.transform.FastCosineTransformer,3,0,3,0,0,0.0,0.0,39,0,39,0,0,0,0.0,0.0,56,55,98.21
commons-math-3.6.1,org.apache.commons.math3.transform.TransformType,0,0,0,0,0,0.0,0.0,0,0,0,0,0,0,0.0,0.0,0,0,0
commons-math-3.6.1,org.apache.commons.math3.transform.FastFourierTransformer$MultiDimensionalComplexMatrix,6,6,0,6,0,100.0,0.0,64,50,14,50,0,0,78.12,0.0,30,25,83.33
commons-math-3.6.1,org.apache.commons.math3.transform.FastFourierTransformer,8,8,0,8,0,100.0,0.0,142,135,7,135,0,0,95.07,0.0,157,153,97.45
commons-math-3.6.1,org.apache.commons.math3.transform.DctNormalization,0,0,0,0,0,0.0,0.0,0,0,0,0,0,0,0.0,0.0,0,0,0
commons-math-3.6.1,org.apache.commons.math3.transform.FastSineTransformer,3,0,3,0,0,0.0,0.0,35,0,35,0,0,0,0.0,0.0,41,40,97.56
commons-math-3.6.1,org.apache.commons.math3.transform.RealTransformer,0,0,0,0,0,0.0,0.0,0,0,0,0,0,0,0.0,0.0,0,0,0
commons-math-3.6.1,org.apache.commons.math3.transform.DftNormalization,0,0,0,0,0,0.0,0.0,0,0,0,0,0,0,0.0,0.0,0,0,0
asw4j,ca.uwaterloo.asw4j.DAGInstructionResolver$MarkableDependencyNode$MARK,0,0,0,0,0,0.0,0.0,0,0,0,0,0,0,0.0,0.0,0,0,0
asw4j,ca.uwaterloo.asw4j.ToolResolver,0,0,0,0,0,0.0,0.0,0,0,0,0,0,0,0.0,0.0,0,0,0
asw4j,ca.uwaterloo.asw4j.ThreadPoolWorkerManager$ThreadPool,3,0,3,0,0,0.0,0.0,40,0,40,0,0,0,0.0,0.0,20,0,0.0
asw4j,ca.uwaterloo.asw4j.DependencyInstructionResolver,0,0,0,0,0,0.0,0.0,0,0,0,0,0,0,0.0,0.0,0,0,0
asw4j,ca.uwaterloo.asw4j.Instruction,2,1,1,0,1,50.0,50.0,10,5,5,5,0,0,50.0,0.0,6,0,0.0
asw4j,ca.uwaterloo.asw4j.DataStore,0,0,0,0,0,0.0,0.0,0,0,0,0,0,0,0.0,0.0,0,0,0
asw4j,ca.uwaterloo.asw4j.Balancer,0,0,0,0,0,0.0,0.0,0,0,0,0,0,0,0.0,0.0,0,0,0
asw4j,ca.uwaterloo.asw4j.AbstractDependencyInstructionResolver,9,3,6,2,1,33.33,11.11,24,16,8,16,0,0,66.67,0.0,14,3,21.43
asw4j,ca.uwaterloo.asw4j.WorkerManager,0,0,0,0,0,0.0,0.0,0,0,0,0,0,0,0.0,0.0,0,0,0
asw4j,ca.uwaterloo.asw4j.AbstractInstructionResolver,5,4,1,4,0,80.0,0.0,17,14,3,14,0,0,82.35,0.0,8,5,62.5
asw4j,ca.uwaterloo.asw4j.DAGInstructionResolver$MarkableDependencyNode,2,2,0,0,2,100.0,100.0,4,4,0,4,0,0,100.0,0.0,1,0,0.0
asw4j,ca.uwaterloo.asw4j.ConcurrentMapDataStore,30,8,22,5,3,26.67,10.0,108,51,57,51,0,0,47.22,0.0,71,39,54.93
asw4j,ca.uwaterloo.asw4j.DataNode,11,10,1,10,0,90.91,0.0,36,27,9,27,0,0,75.0,0.0,20,16,80.0
asw4j,ca.uwaterloo.asw4j.ThreadPoolWorkerManager,7,0,7,0,0,0.0,0.0,43,0,43,0,0,0,0.0,0.0,18,0,0.0
asw4j,ca.uwaterloo.asw4j.DAGInstructionResolver,5,5,0,5,0,100.0,0.0,58,52,6,52,0,0,89.66,0.0,25,16,64.0
asw4j,ca.uwaterloo.asw4j.ThreadPoolWorkerManager$FutureTask,5,0,5,0,0,0.0,0.0,23,0,23,0,0,0,0.0,0.0,14,0,0.0
asw4j,ca.uwaterloo.asw4j.AbstractWorkerManager,7,0,7,0,0,0.0,0.0,8,0,8,0,0,0,0.0,0.0,7,0,0.0
asw4j,ca.uwaterloo.asw4j.InstructionResolver,0,0,0,0,0,0.0,0.0,0,0,0,0,0,0,0.0,0.0,0,0,0
asw4j,ca.uwaterloo.asw4j.Combiner,0,0,0,0,0,0.0,0.0,0,0,0,0,0,0,0.0,0.0,0,0,0
asw4j,ca.uwaterloo.asw4j.WorkerManager$STATE,0,0,0,0,0,0.0,0.0,0,0,0,0,0,0,0.0,0.0,0,0,0
asw4j,ca.uwaterloo.asw4j.SimpleInstructionResolver,6,0,6,0,0,0.0,0.0,25,0,25,0,0,0,0.0,0.0,10,0,0.0
asw4j,ca.uwaterloo.asw4j.internal.InstructionClassUtility,8,8,0,5,3,100.0,37.5,45,45,0,45,0,0,100.0,0.0,25,19,76.0
asw4j,ca.uwaterloo.asw4j.internal.NonBlockingLinkedQueue$Node,0,0,0,0,0,0.0,0.0,1,1,0,1,0,0,100.0,0.0,0,0,0
asw4j,ca.uwaterloo.asw4j.internal.NonBlockingLinkedQueue,22,14,8,14,0,63.64,0.0,101,76,25,59,17,12,75.25,16.83,54,41,75.93
asw4j,ca.uwaterloo.asw4j.internal.Assert,2,2,0,0,2,100.0,100.0,6,4,2,4,0,0,66.67,0.0,4,2,50.0
asw4j,ca.uwaterloo.asw4j.internal.InstructionClassDependencyNode,6,5,1,1,4,83.33,66.67,33,26,7,26,0,0,78.79,0.0,16,5,31.25
asw4j,ca.uwaterloo.asw4j.internal.InstructionClassState,7,3,4,0,3,42.86,42.86,18,5,13,5,0,0,27.78,0.0,13,0,0.0
asw4j,ca.uwaterloo.asw4j.internal.InstructionClassNode,7,7,0,6,1,100.0,14.29,46,42,4,42,0,0,91.3,0.0,24,21,87.5
asw4j,ca.uwaterloo.asw4j.internal.InstructionClassDependencyNode$InstructionClassDependencyState,1,0,1,0,0,0.0,0.0,1,0,1,0,0,0,0.0,0.0,1,0,0.0
asw4j,ca.uwaterloo.asw4j.internal.InstructionClassState$STATE,0,0,0,0,0,0.0,0.0,0,0,0,0,0,0,0.0,0.0,0,0,0
asw4j,ca.uwaterloo.asw4j.internal.DataManipulationObjectMap,4,2,2,0,2,50.0,50.0,6,4,2,4,0,0,66.67,0.0,2,2,100.0
asw4j,ca.uwaterloo.asw4j.reflection.TypeUtility,7,4,3,3,1,57.14,14.29,121,17,104,17,0,0,14.05,0.0,77,8,10.39
asw4j,ca.uwaterloo.asw4j.reflection.TypeToken,7,5,2,4,1,71.43,14.29,16,13,3,13,0,0,81.25,0.0,13,9,69.23
asw4j,ca.uwaterloo.asw4j.reflection.TypeUtility$GenericArrayTypeImpl,3,0,3,0,0,0.0,0.0,4,0,4,0,0,0,0.0,0.0,5,0,0.0
asw4j,ca.uwaterloo.asw4j.reflection.TypeUtility$ParameterizedTypeImpl,4,0,4,0,0,0.0,0.0,22,0,22,0,0,0,0.0,0.0,15,0,0.0
java-json-canonicalization,org.erdtman.jcs.NumberFastDtoaBuilder,7,5,2,4,1,71.43,14.29,57,47,10,47,0,0,82.46,0.0,63,39,61.9
java-json-canonicalization,org.erdtman.jcs.NumberDToA,12,0,12,0,0,0.0,0.0,621,0,621,0,0,0,0.0,0.0,554,0,0.0
java-json-canonicalization,org.erdtman.jcs.JsonCanonicalizer,5,5,0,5,0,100.0,0.0,68,59,9,59,0,0,86.76,0.0,32,27,84.38
java-json-canonicalization,org.erdtman.jcs.NumberDiyFp,10,7,3,4,3,70.0,30.0,43,35,8,35,0,0,81.4,0.0,51,24,47.06
java-json-canonicalization,org.erdtman.jcs.NumberFastDtoa,8,7,1,2,5,87.5,62.5,127,84,43,84,0,0,66.14,0.0,148,50,33.78
java-json-canonicalization,org.erdtman.jcs.JsonDecoder,11,11,0,11,0,100.0,0.0,125,101,24,101,0,0,80.8,0.0,57,55,96.49
java-json-canonicalization,org.erdtman.jcs.NumberCachedPowers$CachedPower,0,0,0,0,0,0.0,0.0,3,3,0,3,0,0,100.0,0.0,0,0,0
java-json-canonicalization,org.erdtman.jcs.NumberDoubleHelper,10,6,4,4,2,60.0,20.0,38,25,13,25,0,0,65.79,0.0,62,23,37.1
java-json-canonicalization,org.erdtman.jcs.NumberCachedPowers,1,1,0,1,0,100.0,0.0,7,7,0,7,0,0,100.0,0.0,11,9,81.82
java-json-canonicalization,org.erdtman.jcs.NumberToJSON,1,1,0,1,0,100.0,0.0,13,6,7,6,0,0,46.15,0.0,8,4,50.0
Xml-Region-Analyzer,net.vzurczak.xml.region.analyzer.XmlRegion,1,1,0,0,1,100.0,100.0,4,4,0,4,0,0,100.0,0.0,1,0,0.0
Xml-Region-Analyzer,net.vzurczak.xml.region.analyzer.XmlRegion$XmlRegionType,0,0,0,0,0,0.0,0.0,0,0,0,0,0,0,0.0,0.0,0,0,0
Xml-Region-Analyzer,net.vzurczak.xml.region.analyzer.XmlRegionAnalyzer,9,9,0,9,0,100.0,0.0,218,212,6,212,0,0,97.25,0.0,192,150,78.12
pm-persistence-utils,com.premiumminds.persistence.JpaGuicePersistenceTransaction,5,4,1,4,0,80.0,0.0,47,37,10,35,2,2,78.72,4.26,25,17,68.0
pm-persistence-utils,com.premiumminds.persistence.PersistenceTransaction,0,0,0,0,0,0.0,0.0,0,0,0,0,0,0,0.0,0.0,0,0,0
pm-persistence-utils,com.premiumminds.persistence.PersistenceTransactionSynchronization$Status,0,0,0,0,0,0.0,0.0,0,0,0,0,0,0,0.0,0.0,0,0,0
pm-persistence-utils,com.premiumminds.persistence.JpaHelper,1,0,1,0,0,0.0,0.0,3,0,3,0,0,0,0.0,0.0,1,0,0.0
pm-persistence-utils,com.premiumminds.persistence.PersistenceTransactionSynchronization,0,0,0,0,0,0.0,0.0,0,0,0,0,0,0,0.0,0.0,0,0,0
pm-persistence-utils,com.premiumminds.persistence.MultiplePersistenceTransaction,6,5,1,5,0,83.33,0.0,57,44,13,44,0,0,77.19,0.0,19,11,57.89
pm-persistence-utils,com.premiumminds.persistence.TransactionWrapper,5,0,5,0,0,0.0,0.0,34,0,34,0,0,0,0.0,0.0,16,0,0.0
pm-persistence-utils,com.premiumminds.persistence.utils.HibernateDDL,8,8,0,8,0,100.0,0.0,85,75,10,75,0,0,88.24,0.0,42,34,80.95
pm-persistence-utils,com.premiumminds.persistence.annotations.Interceptor,2,0,2,0,0,0.0,0.0,2,0,2,0,0,0,0.0,0.0,0,0,0
commons-cli,org.apache.commons.cli.MissingArgumentException,0,0,0,0,0,0.0,0.0,1,1,0,1,0,0,100.0,0.0,0,0,0
commons-cli,org.apache.commons.cli.DefaultParser$Builder,1,1,0,1,0,100.0,0.0,1,1,0,1,0,0,100.0,0.0,1,1,100.0
commons-cli,org.apache.commons.cli.UnrecognizedOptionException,0,0,0,0,0,0.0,0.0,1,1,0,1,0,0,100.0,0.0,0,0,0
commons-cli,org.apache.commons.cli.HelpFormatter$OptionComparator,1,1,0,1,0,100.0,0.0,1,1,0,1,0,0,100.0,0.0,1,1,100.0
commons-cli,org.apache.commons.cli.Options,11,11,0,11,0,100.0,0.0,23,23,0,18,5,5,100.0,21.74,19,19,100.0
commons-cli,org.apache.commons.cli.DefaultParser,27,27,0,26,1,100.0,3.7,213,209,4,209,0,0,98.12,0.0,173,162,93.64
commons-cli,org.apache.commons.cli.CommandLineParser,0,0,0,0,0,0.0,0.0,0,0,0,0,0,0,0.0,0.0,0,0,0
commons-cli,org.apache.commons.cli.AmbiguousOptionException,1,1,0,0,1,100.0,100.0,13,13,0,13,0,0,100.0,0.0,3,0,0.0
commons-cli,org.apache.commons.cli.OptionGroup,5,5,0,5,0,100.0,0.0,29,29,0,29,0,0,100.0,0.0,12,12,100.0
commons-cli,org.apache.commons.cli.ParseException,0,0,0,0,0,0.0,0.0,0,0,0,0,0,0,0.0,0.0,0,0,0
commons-cli,org.apache.commons.cli.PatternOptionBuilder,3,3,0,3,0,100.0,0.0,33,32,1,32,0,0,96.97,0.0,29,29,100.0
commons-cli,org.apache.commons.cli.CommandLine,23,23,0,23,0,100.0,0.0,64,64,0,64,0,0,100.0,0.0,46,46,100.0
commons-cli,org.apache.commons.cli.HelpFormatter,21,17,4,17,0,80.95,0.0,173,167,6,167,0,0,96.53,0.0,117,99,84.62
commons-cli,org.apache.commons.cli.Option,26,26,0,24,2,100.0,7.69,90,81,9,66,15,0,90.0,16.67,75,61,81.33
commons-cli,org.apache.commons.cli.MissingOptionException,1,1,0,1,0,100.0,0.0,10,10,0,10,0,0,100.0,0.0,4,4,100.0
commons-cli,org.apache.commons.cli.CommandLine$Builder,1,1,0,1,0,100.0,0.0,1,1,0,1,0,0,100.0,0.0,1,1,100.0
commons-cli,org.apache.commons.cli.TypeHandler,10,10,0,10,0,100.0,0.0,53,53,0,53,0,0,100.0,0.0,27,25,92.59
commons-cli,org.apache.commons.cli.Option$Builder,4,4,0,4,0,100.0,0.0,8,8,0,8,0,0,100.0,0.0,6,6,100.0
commons-cli,org.apache.commons.cli.Util,2,2,0,2,0,100.0,0.0,14,14,0,14,0,0,100.0,0.0,16,16,100.0
commons-cli,org.apache.commons.cli.AlreadySelectedException,0,0,0,0,0,0.0,0.0,2,2,0,2,0,0,100.0,0.0,0,0,0
commons-cli,org.apache.commons.cli.OptionValidator,3,3,0,3,0,100.0,0.0,15,15,0,15,0,0,100.0,0.0,12,12,100.0
wildfly-swarm-spi,org.wildfly.swarm.spi.runtime.annotations.Literal,0,0,0,0,0,0.0,0.0,0,0,0,0,0,0,0.0,0.0,0,0,0
wildfly-swarm-spi,org.wildfly.swarm.spi.api.ArchivePreparer,0,0,0,0,0,0.0,0.0,0,0,0,0,0,0,0.0,0.0,0,0,0
wildfly-swarm-spi,org.wildfly.swarm.spi.api.JBossDeploymentStructureAsset,11,11,0,10,1,100.0,9.09,87,85,2,84,1,0,97.7,1.15,41,35,85.37
wildfly-swarm-spi,org.wildfly.swarm.spi.api.OutboundSocketBinding,3,0,3,0,0,0.0,0.0,4,0,4,0,0,0,0.0,0.0,3,0,0.0
wildfly-swarm-spi,org.wildfly.swarm.spi.api.SocketBinding,4,0,4,0,0,0.0,0.0,5,0,5,0,0,0,0.0,0.0,4,0,0.0
wildfly-swarm-spi,org.wildfly.swarm.spi.api.StageConfig$Resolver,0,0,0,0,0,0.0,0.0,0,0,0,0,0,0,0.0,0.0,0,0,0
wildfly-swarm-spi,org.wildfly.swarm.spi.api.StageConfig$Converter,0,0,0,0,0,0.0,0.0,0,0,0,0,0,0,0.0,0.0,0,0,0
wildfly-swarm-spi,org.wildfly.swarm.spi.api.ProjectStage,0,0,0,0,0,0.0,0.0,0,0,0,0,0,0,0.0,0.0,0,0,0
wildfly-swarm-spi,org.wildfly.swarm.spi.api.JARArchive,0,0,0,0,0,0.0,0.0,0,0,0,0,0,0,0.0,0.0,0,0,0
wildfly-swarm-spi,org.wildfly.swarm.spi.api.Module$ServiceHandling,1,1,0,1,0,100.0,0.0,2,2,0,2,0,0,100.0,0.0,1,1,100.0
wildfly-swarm-spi,org.wildfly.swarm.spi.api.StageConfig,3,0,3,0,0,0.0,0.0,4,0,4,0,0,0,0.0,0.0,3,0,0.0
wildfly-swarm-spi,org.wildfly.swarm.spi.api.ArtifactLookup,1,0,1,0,0,0.0,0.0,1,0,1,0,0,0,0.0,0.0,7,0,0.0
wildfly-swarm-spi,org.wildfly.swarm.spi.api.ArchiveMetadataProcessor,0,0,0,0,0,0.0,0.0,0,0,0,0,0,0,0.0,0.0,0,0,0
wildfly-swarm-spi,org.wildfly.swarm.spi.api.DependenciesContainer,3,0,3,0,0,0.0,0.0,17,0,17,0,0,0,0.0,0.0,7,0,0.0
wildfly-swarm-spi,org.wildfly.swarm.spi.api.DefaultDeploymentFactory,6,0,6,0,0,0.0,0.0,39,0,39,0,0,0,0.0,0.0,22,0,0.0
wildfly-swarm-spi,org.wildfly.swarm.spi.api.SwarmProperties,2,0,2,0,0,0.0,0.0,2,0,2,0,0,0,0.0,0.0,2,0,0.0
wildfly-swarm-spi,org.wildfly.swarm.spi.api.Module,11,11,0,10,1,100.0,9.09,15,15,0,15,0,0,100.0,0.0,13,11,84.62
wildfly-swarm-spi,org.wildfly.swarm.spi.api.SocketBindingGroup,5,0,5,0,0,0.0,0.0,8,0,8,0,0,0,0.0,0.0,5,0,0.0
wildfly-swarm-spi,org.wildfly.swarm.spi.api.StageConfig$Builder,4,0,4,0,0,0.0,0.0,51,0,51,0,0,0,0.0,0.0,18,0,0.0
wildfly-swarm-spi,org.wildfly.swarm.spi.api.ClassLoading,1,1,0,1,0,100.0,0.0,6,5,1,5,0,0,83.33,0.0,3,1,33.33
wildfly-swarm-spi,org.wildfly.swarm.spi.api.JBossDeploymentStructureContainer,5,0,5,0,0,0.0,0.0,22,0,22,0,0,0,0.0,0.0,10,0,0.0
wildfly-swarm-spi,org.wildfly.swarm.spi.api.Customizer,0,0,0,0,0,0.0,0.0,0,0,0,0,0,0,0.0,0.0,0,0,0
wildfly-swarm-spi,org.wildfly.swarm.spi.api.MarkerContainer,2,0,2,0,0,0.0,0.0,3,0,3,0,0,0,0.0,0.0,3,0,0.0
wildfly-swarm-spi,org.wildfly.swarm.spi.api.Environment,1,0,1,0,0,0.0,0.0,1,0,1,0,0,0,0.0,0.0,4,0,0.0
wildfly-swarm-spi,org.wildfly.swarm.spi.api.Fraction,1,0,1,0,0,0.0,0.0,1,0,1,0,0,0,0.0,0.0,1,0,0.0
wildfly-swarm-spi,org.wildfly.swarm.spi.api.internal.SwarmInternalProperties,0,0,0,0,0,0.0,0.0,0,0,0,0,0,0,0.0,0.0,0,0,0
wildfly-swarm-spi,org.wildfly.swarm.spi.api.annotations.MetaInfDisposition,0,0,0,0,0,0.0,0.0,0,0,0,0,0,0,0.0,0.0,0,0,0
chronometrophobia,com.aaronbedra.chronometrophobia.OTP$OTP1,3,0,3,0,0,0.0,0.0,3,0,3,0,0,0,0.0,0.0,3,0,0.0
chronometrophobia,com.aaronbedra.chronometrophobia.HMac$HMacSHA512,2,1,1,1,0,50.0,0.0,2,1,1,1,0,0,50.0,0.0,3,2,66.67
chronometrophobia,com.aaronbedra.chronometrophobia.TimeStep$TimeStep60,1,0,1,0,0,0.0,0.0,1,0,1,0,0,0,0.0,0.0,1,0,0.0
chronometrophobia,com.aaronbedra.chronometrophobia.OTP,8,2,6,2,0,25.0,0.0,8,2,6,2,0,0,25.0,0.0,8,2,25.0
chronometrophobia,com.aaronbedra.chronometrophobia.HMac,5,5,0,5,0,100.0,0.0,9,9,0,9,0,0,100.0,0.0,13,12,92.31
chronometrophobia,com.aaronbedra.chronometrophobia.OTP$OTP7,3,0,3,0,0,0.0,0.0,3,0,3,0,0,0,0.0,0.0,3,0,0.0
chronometrophobia,com.aaronbedra.chronometrophobia.HMac$HMacSHA1,2,1,1,1,0,50.0,0.0,2,1,1,1,0,0,50.0,0.0,3,2,66.67
chronometrophobia,com.aaronbedra.chronometrophobia.OTP$OTP6,3,2,1,2,0,66.67,0.0,3,2,1,2,0,0,66.67,0.0,3,2,66.67
chronometrophobia,com.aaronbedra.chronometrophobia.HMac$HmacResult,1,0,1,0,0,0.0,0.0,1,0,1,0,0,0,0.0,0.0,1,0,0.0
chronometrophobia,com.aaronbedra.chronometrophobia.HMac$HMacSHA256,2,1,1,1,0,50.0,0.0,2,1,1,1,0,0,50.0,0.0,3,2,66.67
chronometrophobia,com.aaronbedra.chronometrophobia.Counter,2,2,0,2,0,100.0,0.0,8,8,0,8,0,0,100.0,0.0,7,6,85.71
chronometrophobia,com.aaronbedra.chronometrophobia.TimeStep$TimeStep30,1,0,1,0,0,0.0,0.0,1,0,1,0,0,0,0.0,0.0,1,0,0.0
chronometrophobia,com.aaronbedra.chronometrophobia.OTP$Digits,1,0,1,0,0,0.0,0.0,1,0,1,0,0,0,0.0,0.0,1,0,0.0
chronometrophobia,com.aaronbedra.chronometrophobia.OTP$OTP5,3,0,3,0,0,0.0,0.0,3,0,3,0,0,0,0.0,0.0,3,0,0.0
chronometrophobia,com.aaronbedra.chronometrophobia.OTP$OTP4,3,0,3,0,0,0.0,0.0,3,0,3,0,0,0,0.0,0.0,3,0,0.0
chronometrophobia,com.aaronbedra.chronometrophobia.TimeStep,3,1,2,1,0,33.33,0.0,3,1,2,1,0,0,33.33,0.0,3,1,33.33
chronometrophobia,com.aaronbedra.chronometrophobia.Hex,1,1,0,1,0,100.0,0.0,7,7,0,7,0,0,100.0,0.0,10,10,100.0
chronometrophobia,com.aaronbedra.chronometrophobia.TimeStep$TimeStep90,1,0,1,0,0,0.0,0.0,1,0,1,0,0,0,0.0,0.0,1,0,0.0
chronometrophobia,com.aaronbedra.chronometrophobia.OTP$OTP8,3,2,1,2,0,66.67,0.0,3,2,1,2,0,0,66.67,0.0,3,2,66.67
chronometrophobia,com.aaronbedra.chronometrophobia.OTP$Power,1,0,1,0,0,0.0,0.0,1,0,1,0,0,0,0.0,0.0,1,0,0.0
chronometrophobia,com.aaronbedra.chronometrophobia.OTP$OTP3,3,0,3,0,0,0.0,0.0,3,0,3,0,0,0,0.0,0.0,3,0,0.0
chronometrophobia,com.aaronbedra.chronometrophobia.TimeStamp,2,1,1,1,0,50.0,0.0,2,1,1,1,0,0,50.0,0.0,4,1,25.0
chronometrophobia,com.aaronbedra.chronometrophobia.Failure,1,0,1,0,0,0.0,0.0,1,0,1,0,0,0,0.0,0.0,1,0,0.0
chronometrophobia,com.aaronbedra.chronometrophobia.Totp,4,4,0,4,0,100.0,0.0,8,8,0,8,0,0,100.0,0.0,25,24,96.0
chronometrophobia,com.aaronbedra.chronometrophobia.Seed,2,1,1,1,0,50.0,0.0,2,1,1,1,0,0,50.0,0.0,5,1,20.0
chronometrophobia,com.aaronbedra.chronometrophobia.OTP$OTP2,3,0,3,0,0,0.0,0.0,3,0,3,0,0,0,0.0,0.0,3,0,0.0
chronometrophobia,com.aaronbedra.chronometrophobia.HMac$HmacKey,1,0,1,0,0,0.0,0.0,1,0,1,0,0,0,0.0,0.0,1,0,0.0
ext4logback,org.fuin.ext4logback.LogbackStandalone,6,3,3,3,0,50.0,0.0,39,15,24,15,0,0,38.46,0.0,20,8,40.0
ext4logback,org.fuin.ext4logback.NewLogConfigFileParams,1,0,1,0,0,0.0,0.0,6,5,1,5,0,0,83.33,0.0,1,0,0.0
data-conjuror,com.kestreldigital.conjuror.Conjuror,5,0,5,0,0,0.0,0.0,8,0,8,0,0,0,0.0,0.0,5,0,0.0
data-conjuror,com.kestreldigital.conjuror.NameConjuror,3,3,0,0,3,100.0,100.0,7,7,0,5,2,0,100.0,28.57,3,2,66.67
data-conjuror,com.kestreldigital.conjuror.StringConjuror,1,1,0,1,0,100.0,0.0,2,2,0,2,0,0,100.0,0.0,1,1,100.0
data-conjuror,com.kestreldigital.conjuror.DateConjuror,1,0,1,0,0,0.0,0.0,4,0,4,0,0,0,0.0,0.0,15,0,0.0
data-conjuror,com.kestreldigital.conjuror.utils.ResourceUtils,1,1,0,0,1,100.0,100.0,6,6,0,6,0,0,100.0,0.0,1,1,100.0
data-conjuror,com.kestreldigital.conjuror.utils.RandomUtils,1,1,0,0,1,100.0,100.0,2,2,0,1,1,0,100.0,50.0,1,0,0.0
payload-offloading-java-common-lib-for-aws,software.amazon.payloadoffloading.PayloadStoreAsync,0,0,0,0,0,0.0,0.0,0,0,0,0,0,0,0.0,0.0,0,0,0
payload-offloading-java-common-lib-for-aws,software.amazon.payloadoffloading.S3BackedPayloadStore,4,4,0,4,0,100.0,0.0,18,18,0,16,2,2,100.0,11.11,5,5,100.0
payload-offloading-java-common-lib-for-aws,software.amazon.payloadoffloading.S3Dao,3,1,2,1,0,33.33,0.0,36,12,24,12,0,0,33.33,0.0,5,3,60.0
payload-offloading-java-common-lib-for-aws,software.amazon.payloadoffloading.ServerSideEncryptionStrategy,0,0,0,0,0,0.0,0.0,0,0,0,0,0,0,0.0,0.0,0,0,0
payload-offloading-java-common-lib-for-aws,software.amazon.payloadoffloading.CustomerKey,1,1,0,1,0,100.0,0.0,3,3,0,3,0,0,100.0,0.0,0,0,0
payload-offloading-java-common-lib-for-aws,software.amazon.payloadoffloading.ServerSideEncryptionFactory,2,1,1,1,0,50.0,0.0,2,1,1,1,0,0,50.0,0.0,2,1,50.0
payload-offloading-java-common-lib-for-aws,software.amazon.payloadoffloading.CountingOutputStream,3,0,3,0,0,0.0,0.0,3,0,3,0,0,0,0.0,0.0,3,0,0.0
payload-offloading-java-common-lib-for-aws,software.amazon.payloadoffloading.PayloadStorageConfiguration,2,2,0,1,1,100.0,50.0,11,7,4,3,4,1,63.64,36.36,4,3,75.0
payload-offloading-java-common-lib-for-aws,software.amazon.payloadoffloading.PayloadStorageAsyncConfiguration,2,2,0,1,1,100.0,50.0,12,8,4,3,5,1,66.67,41.67,4,3,75.0
payload-offloading-java-common-lib-for-aws,software.amazon.payloadoffloading.AwsManagedCmk,1,1,0,1,0,100.0,0.0,1,1,0,1,0,0,100.0,0.0,0,0,0
payload-offloading-java-common-lib-for-aws,software.amazon.payloadoffloading.PayloadStore,0,0,0,0,0,0.0,0.0,0,0,0,0,0,0,0.0,0.0,0,0,0
payload-offloading-java-common-lib-for-aws,software.amazon.payloadoffloading.S3BackedPayloadStoreAsync,4,4,0,4,0,100.0,0.0,21,21,0,21,0,0,100.0,0.0,10,8,80.0
payload-offloading-java-common-lib-for-aws,software.amazon.payloadoffloading.PayloadStorageConfigurationBase,5,5,0,3,2,100.0,40.0,26,20,6,10,10,3,76.92,38.46,8,6,75.0
payload-offloading-java-common-lib-for-aws,software.amazon.payloadoffloading.S3AsyncDao,3,3,0,3,0,100.0,0.0,15,15,0,15,0,0,100.0,0.0,14,10,71.43
payload-offloading-java-common-lib-for-aws,software.amazon.payloadoffloading.Util,3,0,3,0,0,0.0,0.0,15,0,15,0,0,0,0.0,0.0,8,0,0.0
payload-offloading-java-common-lib-for-aws,software.amazon.payloadoffloading.PayloadS3Pointer,2,2,0,2,0,100.0,0.0,18,15,3,12,3,3,83.33,16.67,2,2,100.0
payload-offloading-java-common-lib-for-aws,software.amazon.payloadoffloading.JsonDataConverter,2,2,0,2,0,100.0,0.0,7,7,0,4,3,0,100.0,42.86,2,2,100.0
wcomponents-sass-compiler,com.github.bordertech.wcomponents.sass.SassCompiler,5,5,0,5,0,100.0,0.0,35,29,6,29,0,0,82.86,0.0,17,6,35.29
wcomponents-sass-compiler,com.github.bordertech.wcomponents.sass.SassTask,2,2,0,2,0,100.0,0.0,27,17,10,17,0,0,62.96,0.0,8,3,37.5
